//MAP CONVERTED BY dmm2tgm.py THIS HEADER COMMENT PREVENTS RECONVERSION, DO NOT REMOVE
"a" = (
/turf/template_noop,
/area/template_noop)
"q" = (
/obj/item/kitchen/knife/combat/bone,
/turf/open/floor/plating/asteroid/basalt/lava_land_surface,
/area/lavaland/surface/outdoors)
"v" = (
/obj/effect/decal/cleanable/blood/gibs,
/turf/open/floor/plating/asteroid/basalt/lava_land_surface,
/area/lavaland/surface/outdoors)
"A" = (
/obj/structure/bonfire,
/turf/open/floor/plating/asteroid/basalt/lava_land_surface,
/area/lavaland/surface/outdoors)
"B" = (
/turf/closed/mineral/volcanic/lava_land_surface,
/area/lavaland/surface/outdoors/unexplored)
"E" = (
/turf/open/floor/plating/asteroid/basalt/lava_land_surface,
/area/lavaland/surface/outdoors/unexplored)
"L" = (
/turf/open/floor/plating/asteroid/basalt/lava_land_surface,
/area/lavaland/surface/outdoors)
"Q" = (
/obj/item/clothing/accessory/skullcodpiece,
/turf/open/floor/plating/asteroid/basalt/lava_land_surface,
/area/lavaland/surface/outdoors)

(1,1,1) = {"
a
E
E
E
E
B
a
"}
(2,1,1) = {"
E
E
v
E
E
B
B
"}
(3,1,1) = {"
E
E
v
v
E
E
B
"}
(4,1,1) = {"
B
L
L
L
Q
E
B
"}
(5,1,1) = {"
B
L
L
A
L
E
B
"}
(6,1,1) = {"
B
E
q
L
L
E
B
"}
(7,1,1) = {"
B
B
E
L
L
E
B
"}
(8,1,1) = {"
a
B
B
E
E
B
a
"}
