//MAP CONVERTED BY dmm2tgm.py THIS HEADER COMMENT PREVENTS RECONVERSION, DO NOT REMOVE
"a" = (
/turf/template_noop,
/area/template_noop)
"d" = (
/obj/structure/statue/bone/skull/half{
	dir = 1
	},
/turf/open/floor/plating/asteroid/basalt/lava_land_surface,
/area/lavaland/surface/outdoors)
"k" = (
/obj/structure/stone_tile/burnt,
/turf/open/floor/plating/asteroid/basalt/lava_land_surface,
/area/lavaland/surface/outdoors)
"q" = (
/obj/structure/statue/bone/skull/half,
/turf/open/floor/plating/asteroid/basalt/lava_land_surface,
/area/lavaland/surface/outdoors)
"z" = (
/turf/open/floor/plating/asteroid/basalt/lava_land_surface,
/area/lavaland/surface/outdoors)
"H" = (
/turf/closed/mineral/volcanic/lava_land_surface,
/area/lavaland/surface/outdoors)
"K" = (
/obj/structure/stone_tile/block/cracked,
/turf/open/floor/plating/asteroid/basalt/lava_land_surface,
/area/lavaland/surface/outdoors)
"N" = (
/obj/structure/statue/bone/rib{
	dir = 1
	},
/turf/open/floor/plating/asteroid/basalt/lava_land_surface,
/area/lavaland/surface/outdoors)
"S" = (
/obj/structure/stone_tile/block/cracked{
	dir = 4
	},
/turf/open/floor/plating/asteroid/basalt/lava_land_surface,
/area/lavaland/surface/outdoors)
"U" = (
/obj/structure/stone_tile/surrounding/cracked,
/obj/structure/stone_tile/center/cracked,
/turf/open/floor/plating/asteroid/basalt/lava_land_surface,
/area/lavaland/surface/outdoors)
"W" = (
/obj/structure/statue/bone/rib,
/turf/open/floor/plating/asteroid/basalt/lava_land_surface,
/area/lavaland/surface/outdoors)

(1,1,1) = {"
a
a
z
U
z
z
a
a
"}
(2,1,1) = {"
z
z
N
z
N
z
z
a
"}
(3,1,1) = {"
z
q
z
z
z
z
N
z
"}
(4,1,1) = {"
z
d
z
z
z
z
z
z
"}
(5,1,1) = {"
z
S
W
z
z
z
z
z
"}
(6,1,1) = {"
H
z
k
z
W
z
W
K
"}
(7,1,1) = {"
a
H
H
a
a
a
a
a
"}
