//MAP CONVERTED BY dmm2tgm.py THIS HEADER COMMENT PREVENTS RECONVERSION, DO NOT REMOVE
"a" = (
/turf/template_noop,
/area/template_noop)
"d" = (
/obj/structure/flora/ausbushes/leafybush,
/turf/open/floor/plating/smooth/grass/lavaland_jungle,
/area/lavaland/surface/outdoors)
"g" = (
/obj/structure/flora/junglebush/b,
/turf/open/floor/plating/smooth/grass/lavaland_jungle,
/area/lavaland/surface/outdoors)
"i" = (
/obj/structure/flora/ausbushes/pointybush,
/turf/open/floor/plating/smooth/grass/lavaland_jungle,
/area/lavaland/surface/outdoors)
"B" = (
/turf/open/floor/plating/smooth/grass/lavaland_jungle,
/area/lavaland/surface/outdoors)
"E" = (
/obj/structure/flora/tree/jungle/small,
/turf/open/floor/plating/smooth/grass/lavaland_jungle,
/area/lavaland/surface/outdoors)
"F" = (
/obj/structure/flora/junglebush/c,
/turf/open/floor/plating/smooth/grass/lavaland_jungle,
/area/lavaland/surface/outdoors)
"H" = (
/obj/structure/flora/junglebush,
/turf/open/floor/plating/smooth/grass/lavaland_jungle,
/area/lavaland/surface/outdoors)
"J" = (
/obj/structure/flora/ausbushes/fullgrass,
/turf/open/floor/plating/smooth/grass/lavaland_jungle,
/area/lavaland/surface/outdoors)
"N" = (
/turf/open/water/lavaland/lavaland_jungle,
/area/lavaland/surface/outdoors)
"S" = (
/turf/closed/mineral/volcanic/lava_land_surface,
/area/lavaland/surface/outdoors/unexplored)
"X" = (
/turf/open/floor/plating/asteroid/basalt/lava_land_surface,
/area/lavaland/surface/outdoors)
"Z" = (
/obj/structure/flora/junglebush/large,
/turf/open/floor/plating/smooth/grass/lavaland_jungle,
/area/lavaland/surface/outdoors)

(1,1,1) = {"
a
a
S
S
S
S
S
S
a
"}
(2,1,1) = {"
S
S
S
B
B
E
S
S
S
"}
(3,1,1) = {"
S
S
g
B
N
J
B
X
S
"}
(4,1,1) = {"
S
S
B
N
N
N
i
X
X
"}
(5,1,1) = {"
S
X
B
N
N
N
B
F
X
"}
(6,1,1) = {"
S
X
d
N
N
N
N
B
a
"}
(7,1,1) = {"
S
X
B
Z
N
N
N
B
a
"}
(8,1,1) = {"
S
X
B
E
N
N
H
B
a
"}
(9,1,1) = {"
a
X
X
B
B
J
B
S
a
"}
(10,1,1) = {"
a
S
X
X
S
S
S
S
a
"}
