//MAP CONVERTED BY dmm2tgm.py THIS HEADER COMMENT PREVENTS RECONVERSION, DO NOT REMOVE
"a" = (
/turf/template_noop,
/area/space)
"p" = (
/turf/closed/indestructible/riveted/boss,
/area/summoning_altar)
"w" = (
/obj/structure/summoning_altar,
/turf/open/floor/plating/asteroid/basalt/lava_land_surface,
/area/summoning_altar)
"B" = (
/turf/open/floor/plating/asteroid/basalt/lava_land_surface,
/area/summoning_altar)
"C" = (
/obj/structure/stone_tile/slab,
/turf/open/floor/plating/asteroid/basalt/lava_land_surface,
/area/summoning_altar)
"E" = (
/turf/open/lava/smooth/lava_land_surface,
/area/summoning_altar)

(1,1,1) = {"
a
a
a
a
a
a
a
a
a
E
E
E
E
E
E
E
E
E
E
E
a
a
a
a
a
a
a
a
a
"}
(2,1,1) = {"
a
a
a
a
a
a
E
E
E
E
E
E
E
E
E
E
E
E
E
E
E
E
E
a
a
a
a
a
a
"}
(3,1,1) = {"
a
a
a
a
a
E
E
E
E
E
E
E
E
E
E
E
E
E
E
E
E
E
E
E
a
a
a
a
a
"}
(4,1,1) = {"
a
a
a
a
E
E
E
E
E
p
p
p
C
C
C
C
C
p
p
p
E
E
E
E
E
a
a
a
a
"}
(5,1,1) = {"
a
a
a
E
E
E
p
p
p
p
B
B
B
B
B
B
B
B
B
p
p
p
p
E
E
E
a
a
a
"}
(6,1,1) = {"
a
a
E
E
E
p
p
B
B
B
B
B
B
B
B
B
B
B
B
B
B
B
p
p
E
E
E
a
a
"}
(7,1,1) = {"
a
E
E
E
p
p
B
B
B
B
B
B
B
B
B
B
B
B
B
B
B
B
B
p
p
E
E
E
a
"}
(8,1,1) = {"
a
E
E
E
p
B
B
B
B
B
B
B
B
B
B
B
B
B
B
B
B
B
B
B
p
E
E
E
a
"}
(9,1,1) = {"
a
E
E
E
p
B
B
B
B
B
B
B
B
B
B
B
B
B
B
B
B
B
B
B
p
E
E
E
a
"}
(10,1,1) = {"
E
E
E
p
p
B
B
B
B
B
B
B
B
B
B
B
B
B
B
B
B
B
B
B
p
p
E
E
E
"}
(11,1,1) = {"
E
E
E
p
B
B
B
B
B
B
B
B
B
B
B
B
B
B
B
B
B
B
B
B
B
p
E
E
E
"}
(12,1,1) = {"
E
E
E
p
B
B
B
B
B
B
B
B
B
B
B
B
B
B
B
B
B
B
B
B
B
p
E
E
E
"}
(13,1,1) = {"
E
E
E
C
B
B
B
B
B
B
B
B
B
B
B
B
B
B
B
B
B
B
B
B
B
C
E
E
E
"}
(14,1,1) = {"
E
E
E
C
B
B
B
B
B
B
B
B
B
B
B
B
B
B
B
B
B
B
B
B
B
C
E
E
E
"}
(15,1,1) = {"
E
E
E
C
B
B
B
B
B
B
B
B
B
B
w
B
B
B
B
B
B
B
B
B
B
C
E
E
E
"}
(16,1,1) = {"
E
E
E
C
B
B
B
B
B
B
B
B
B
B
B
B
B
B
B
B
B
B
B
B
B
C
E
E
E
"}
(17,1,1) = {"
E
E
E
C
B
B
B
B
B
B
B
B
B
B
B
B
B
B
B
B
B
B
B
B
B
C
E
E
E
"}
(18,1,1) = {"
E
E
E
p
B
B
B
B
B
B
B
B
B
B
B
B
B
B
B
B
B
B
B
B
B
p
E
E
E
"}
(19,1,1) = {"
E
E
E
p
B
B
B
B
B
B
B
B
B
B
B
B
B
B
B
B
B
B
B
B
B
p
E
E
E
"}
(20,1,1) = {"
E
E
E
p
p
B
B
B
B
B
B
B
B
B
B
B
B
B
B
B
B
B
B
B
p
p
E
E
E
"}
(21,1,1) = {"
a
E
E
E
p
B
B
B
B
B
B
B
B
B
B
B
B
B
B
B
B
B
B
B
p
E
E
E
a
"}
(22,1,1) = {"
a
E
E
E
p
B
B
B
B
B
B
B
B
B
B
B
B
B
B
B
B
B
B
B
p
E
E
E
a
"}
(23,1,1) = {"
a
E
E
E
p
p
B
B
B
B
B
B
B
B
B
B
B
B
B
B
B
B
B
p
p
E
E
E
a
"}
(24,1,1) = {"
a
a
E
E
E
p
p
B
B
B
B
B
B
B
B
B
B
B
B
B
B
B
p
p
E
E
E
a
a
"}
(25,1,1) = {"
a
a
a
E
E
E
p
p
p
p
B
B
B
B
B
B
B
B
B
p
p
p
p
E
E
E
a
a
a
"}
(26,1,1) = {"
a
a
a
a
E
E
E
E
E
p
p
p
C
C
C
C
C
p
p
p
E
E
E
E
E
a
a
a
a
"}
(27,1,1) = {"
a
a
a
a
a
E
E
E
E
E
E
E
E
E
E
E
E
E
E
E
E
E
E
E
a
a
a
a
a
"}
(28,1,1) = {"
a
a
a
a
a
a
E
E
E
E
E
E
E
E
E
E
E
E
E
E
E
E
E
a
a
a
a
a
a
"}
(29,1,1) = {"
a
a
a
a
a
a
a
a
a
E
E
E
E
E
E
E
E
E
E
E
a
a
a
a
a
a
a
a
a
"}
