//MAP CONVERTED BY dmm2tgm.py THIS HEADER COMMENT PREVENTS RECONVERSION, DO NOT REMOVE
"aJ" = (
/turf/template_noop,
/area/template_noop)
"aR" = (
/obj/machinery/light{
	dir = 1
	},
/turf/open/floor/plasteel/freezer,
/area/ruin/powered/seedvault)
"bc" = (
/obj/structure/disposalpipe/segment,
/turf/closed/wall/r_wall,
/area/ruin/powered/seedvault)
"bs" = (
/obj/machinery/chem_master/condimaster,
/turf/open/floor/plasteel/freezer,
/area/ruin/powered/seedvault)
"by" = (
/obj/machinery/light,
/obj/effect/mob_spawn/human/seed_vault,
/turf/open/floor/plasteel/freezer,
/area/ruin/powered/seedvault)
"cU" = (
/obj/effect/decal/cleanable/dirt/dust,
/turf/open/floor/plating,
/area/ruin/powered/seedvault)
"do" = (
/obj/structure/barricade/wooden,
/turf/open/floor/plating/asteroid/basalt/lava_land_surface,
/area/ruin/powered/seedvault)
"ec" = (
/obj/machinery/door/airlock/external,
/obj/effect/mapping_helpers/airlock/cyclelink_helper{
	dir = 4
	},
/turf/open/floor/plating,
/area/ruin/powered/seedvault)
"ev" = (
/obj/structure/closet/crate/hydroponics,
/obj/structure/beebox,
/obj/item/melee/flyswatter,
/obj/item/honey_frame,
/obj/item/honey_frame,
/obj/item/honey_frame,
/obj/item/queen_bee/bought,
/obj/item/clothing/head/beekeeper_head,
/obj/item/clothing/suit/beekeeper_suit,
/turf/open/floor/plasteel/freezer,
/area/ruin/powered/seedvault)
"fc" = (
/obj/machinery/light,
/obj/machinery/hydroponics/constructable,
/turf/open/floor/plasteel/freezer,
/area/ruin/powered/seedvault)
"fr" = (
/obj/item/lighter,
/obj/item/lighter,
/obj/structure/table/reinforced,
/turf/open/floor/plasteel/freezer,
/area/ruin/powered/seedvault)
"fs" = (
/obj/structure/rack,
/obj/item/storage/bag/plants,
/obj/item/storage/bag/plants,
/obj/item/storage/bag/plants,
/obj/item/storage/bag/plants,
/turf/open/floor/plasteel/freezer,
/area/ruin/powered/seedvault)
"hr" = (
/obj/structure/closet/crate/hydroponics,
/obj/item/cultivator,
/obj/item/cultivator,
/obj/item/cultivator,
/obj/item/cultivator,
/obj/item/shovel/spade,
/obj/item/shovel/spade,
/obj/item/shovel/spade,
/obj/item/shovel/spade,
/obj/item/hatchet,
/obj/item/hatchet,
/obj/item/hatchet,
/obj/item/hatchet,
/turf/open/floor/plasteel/freezer,
/area/ruin/powered/seedvault)
"hH" = (
/turf/open/floor/plasteel/showroomfloor,
/area/ruin/powered/seedvault)
"hX" = (
/obj/structure/barricade/wooden,
/obj/structure/disposalpipe/segment,
/turf/open/floor/plating/asteroid/basalt/lava_land_surface,
/area/ruin/powered/seedvault)
"jb" = (
/obj/machinery/light{
	dir = 4
	},
/obj/structure/disposalpipe/segment,
/turf/open/floor/plasteel/freezer,
/area/ruin/powered/seedvault)
"jg" = (
/obj/machinery/seed_extractor,
/turf/open/floor/plasteel/showroomfloor,
/area/ruin/powered/seedvault)
"jV" = (
/obj/structure/table/reinforced,
/obj/machinery/smartfridge/disks{
	pixel_y = 2
	},
/turf/open/floor/plasteel/freezer,
/area/ruin/powered/seedvault)
"kq" = (
/obj/machinery/smartfridge,
/turf/open/floor/plasteel/showroomfloor,
/area/ruin/powered/seedvault)
"lx" = (
/obj/machinery/door/airlock/external,
/obj/structure/fans/tiny,
/obj/effect/mapping_helpers/airlock/cyclelink_helper{
	dir = 8
	},
/turf/open/floor/plating,
/area/ruin/powered/seedvault)
"lR" = (
/obj/machinery/hydroponics/constructable,
/turf/open/floor/plasteel/showroomfloor,
/area/ruin/powered/seedvault)
"lY" = (
/turf/open/floor/plating/asteroid/basalt/lava_land_surface,
/area/lavaland/surface/outdoors)
"mw" = (
/obj/machinery/reagentgrinder{
	pixel_y = 5
	},
/obj/item/reagent_containers/glass/beaker/bluespace,
/obj/item/reagent_containers/glass/beaker/bluespace,
/obj/item/reagent_containers/glass/beaker/bluespace,
/obj/item/reagent_containers/glass/beaker/bluespace,
/obj/structure/table/reinforced,
/turf/open/floor/plasteel/freezer,
/area/ruin/powered/seedvault)
"mV" = (
/obj/machinery/light{
	dir = 1
	},
/obj/structure/table/reinforced,
/obj/machinery/plantgenes/seedvault{
	pixel_y = 6
	},
/turf/open/floor/plasteel/freezer,
/area/ruin/powered/seedvault)
"nd" = (
/obj/item/storage/toolbox/syndicate,
/obj/structure/disposalpipe/segment,
/obj/structure/table/reinforced,
/turf/open/floor/plasteel/freezer,
/area/ruin/powered/seedvault)
"ni" = (
/obj/effect/spawner/lootdrop/seed_vault,
/obj/structure/closet/crate,
/turf/open/floor/plasteel/freezer,
/area/ruin/powered/seedvault)
"nH" = (
/obj/structure/shuttle/engine/large{
	dir = 4
	},
/turf/open/floor/plating,
/area/ruin/powered/seedvault)
"ot" = (
/obj/structure/sink{
	dir = 4;
	pixel_x = 11
	},
/obj/structure/disposalpipe/segment,
/turf/open/floor/plasteel/freezer,
/area/ruin/powered/seedvault)
"rW" = (
/obj/machinery/light{
	dir = 8
	},
/turf/open/floor/plasteel/freezer,
/area/ruin/powered/seedvault)
"sz" = (
/obj/structure/disposalpipe/trunk{
	dir = 1
	},
/turf/open/floor/plating/asteroid/basalt/lava_land_surface,
/area/lavaland/surface/outdoors)
"sO" = (
/obj/structure/sink{
	dir = 4;
	pixel_x = 11
	},
/turf/open/floor/plasteel/freezer,
/area/ruin/powered/seedvault)
"tB" = (
/turf/open/floor/plating,
/area/ruin/powered/seedvault)
"uO" = (
/obj/machinery/disposal/bin,
/obj/structure/disposalpipe/trunk{
	dir = 4
	},
/turf/open/floor/plasteel/showroomfloor,
/area/ruin/powered/seedvault)
"vh" = (
/obj/machinery/light{
	dir = 4
	},
/turf/open/floor/plasteel/freezer,
/area/ruin/powered/seedvault)
"vo" = (
/obj/structure/disposalpipe/segment,
/turf/open/floor/plating,
/area/ruin/powered/seedvault)
"wa" = (
/obj/machinery/hydroponics/constructable,
/obj/machinery/light,
/turf/open/floor/plasteel/freezer,
/area/ruin/powered/seedvault)
"wB" = (
/obj/effect/mob_spawn/human/seed_vault,
/turf/open/floor/plasteel/freezer,
/area/ruin/powered/seedvault)
"ya" = (
/obj/structure/table_frame,
/obj/effect/decal/cleanable/dirt/dust,
/turf/open/floor/plasteel/freezer,
/area/ruin/powered/seedvault)
"yq" = (
/obj/machinery/light{
	dir = 1
	},
/obj/machinery/hydroponics/constructable,
/turf/open/floor/plasteel/freezer,
/area/ruin/powered/seedvault)
"yS" = (
/obj/structure/closet/crate/hydroponics,
/obj/item/clothing/under/rank/civilian/hydroponics,
/obj/item/clothing/under/rank/civilian/hydroponics,
/obj/item/clothing/under/rank/civilian/hydroponics,
/obj/item/clothing/under/rank/civilian/hydroponics,
/turf/open/floor/plasteel/freezer,
/area/ruin/powered/seedvault)
"AO" = (
/obj/item/reagent_containers/glass/bucket,
/obj/item/reagent_containers/glass/bucket,
/obj/item/reagent_containers/glass/bucket,
/obj/item/reagent_containers/glass/bucket,
/obj/structure/table/reinforced,
/turf/open/floor/plasteel/freezer,
/area/ruin/powered/seedvault)
"Bi" = (
/obj/item/disk/design_disk/plant_disk,
/obj/machinery/autolathe/hacked{
	desc = "This autolathe seems to have its safety light off."
	},
/turf/open/floor/plasteel/freezer,
/area/ruin/powered/seedvault)
"Bs" = (
/obj/machinery/light{
	dir = 1
	},
/obj/effect/mob_spawn/human/seed_vault,
/turf/open/floor/plasteel/freezer,
/area/ruin/powered/seedvault)
"DI" = (
/obj/machinery/smartfridge,
/turf/open/floor/plasteel/freezer,
/area/ruin/powered/seedvault)
"Hk" = (
/obj/structure/disposalpipe/segment{
	dir = 10
	},
/turf/open/floor/plasteel/freezer,
/area/ruin/powered/seedvault)
"Hw" = (
/obj/machinery/vending/hydroseeds,
/turf/open/floor/plasteel/showroomfloor,
/area/ruin/powered/seedvault)
"ID" = (
/obj/structure/disposalpipe/segment,
/turf/open/floor/plasteel/freezer,
/area/ruin/powered/seedvault)
"IS" = (
/turf/closed/mineral/volcanic/lava_land_surface,
/area/lavaland/surface/outdoors)
"KN" = (
/obj/effect/decal/cleanable/dirt/dust,
/turf/open/floor/plasteel/freezer,
/area/ruin/powered/seedvault)
"Mb" = (
/turf/open/floor/plasteel/freezer,
/area/ruin/powered/seedvault)
"NI" = (
/obj/machinery/chem_dispenser/mutagensaltpeter,
/turf/open/floor/plasteel/showroomfloor,
/area/ruin/powered/seedvault)
"NN" = (
/obj/item/reagent_containers/glass/bucket,
/turf/open/floor/plasteel/freezer,
/area/ruin/powered/seedvault)
"Py" = (
/obj/machinery/biogenerator,
/turf/open/floor/plasteel/showroomfloor,
/area/ruin/powered/seedvault)
"Qv" = (
/turf/closed/wall/r_wall,
/area/ruin/powered/seedvault)
"QS" = (
/obj/structure/shuttle/engine/propulsion{
	dir = 4
	},
/turf/open/floor/plating,
/area/ruin/powered/seedvault)
"Rd" = (
/obj/item/gun/energy/floragun,
/obj/item/gun/energy/floragun,
/obj/item/gun/energy/floragun,
/obj/item/gun/energy/floragun,
/obj/item/storage/box/disks_plantgene,
/obj/structure/table/reinforced,
/turf/open/floor/plasteel/freezer,
/area/ruin/powered/seedvault)
"Rg" = (
/obj/structure/window/reinforced{
	dir = 8
	},
/turf/open/floor/plating,
/area/ruin/powered/seedvault)
"RW" = (
/obj/machinery/vending/hydronutrients,
/turf/open/floor/plasteel/showroomfloor,
/area/ruin/powered/seedvault)
"Sf" = (
/obj/structure/sink{
	dir = 8;
	pixel_x = -12;
	pixel_y = 2
	},
/turf/open/floor/plasteel/freezer,
/area/ruin/powered/seedvault)
"Sm" = (
/obj/structure/table_frame,
/turf/open/floor/plasteel/freezer,
/area/ruin/powered/seedvault)
"Vc" = (
/obj/machinery/door/airlock,
/turf/open/floor/plasteel/freezer,
/area/ruin/powered/seedvault)
"VI" = (
/obj/structure/rack,
/obj/item/storage/box/disks_plantgene,
/obj/item/storage/box/disks_plantgene,
/turf/open/floor/plasteel/freezer,
/area/ruin/powered/seedvault)
"VV" = (
/obj/structure/disposalpipe/segment{
	dir = 4
	},
/turf/open/floor/plasteel/freezer,
/area/ruin/powered/seedvault)
"Wu" = (
/obj/structure/closet/crate,
/obj/effect/spawner/lootdrop/seed_vault,
/turf/open/floor/plasteel/freezer,
/area/ruin/powered/seedvault)
"Xy" = (
/obj/machinery/hydroponics/constructable,
/turf/open/floor/plasteel/freezer,
/area/ruin/powered/seedvault)
"XG" = (
/obj/item/hatchet,
/turf/open/floor/plasteel/freezer,
/area/ruin/powered/seedvault)

(1,1,1) = {"
aJ
aJ
aJ
aJ
aJ
aJ
Qv
Qv
Qv
Qv
Qv
Qv
IS
aJ
aJ
aJ
aJ
aJ
"}
(2,1,1) = {"
aJ
aJ
aJ
aJ
aJ
Qv
Qv
wB
Mb
Mb
wB
Qv
Qv
IS
aJ
aJ
aJ
aJ
"}
(3,1,1) = {"
aJ
aJ
aJ
IS
IS
Qv
Qv
Bs
Mb
Mb
by
Qv
Qv
IS
IS
aJ
aJ
aJ
"}
(4,1,1) = {"
aJ
IS
Qv
Qv
Qv
Qv
Qv
Qv
Vc
Vc
Qv
Qv
Qv
Qv
Qv
Qv
IS
aJ
"}
(5,1,1) = {"
aJ
Qv
Qv
Wu
Qv
DI
rW
Sf
Mb
Mb
Sf
rW
Bi
Qv
ni
Qv
Qv
aJ
"}
(6,1,1) = {"
aJ
Qv
fr
Mb
Qv
hr
Mb
Mb
Mb
Mb
Mb
Mb
yS
Qv
KN
fs
Qv
aJ
"}
(7,1,1) = {"
aJ
Qv
mV
Mb
Qv
yq
Mb
Mb
RW
Hw
Mb
Mb
fc
Qv
KN
KN
Qv
aJ
"}
(8,1,1) = {"
aJ
Qv
jV
Mb
Vc
Mb
Mb
Mb
jg
Py
Mb
Mb
Mb
Vc
KN
KN
Qv
aJ
"}
(9,1,1) = {"
aJ
Qv
VI
Mb
Qv
Xy
Mb
NN
hH
hH
Mb
Mb
Xy
Qv
ya
XG
Qv
aJ
"}
(10,1,1) = {"
aJ
Qv
Mb
Mb
Qv
Xy
Mb
Mb
hH
hH
Mb
Mb
Xy
Qv
Sm
cU
Qv
aJ
"}
(11,1,1) = {"
IS
Qv
Mb
Mb
Qv
Xy
Mb
Mb
hH
hH
NN
Mb
Xy
Qv
tB
cU
Qv
aJ
"}
(12,1,1) = {"
IS
Qv
aR
Mb
Qv
yq
Mb
Mb
kq
lR
Mb
Mb
wa
Qv
Rg
Rg
Qv
aJ
"}
(13,1,1) = {"
IS
Qv
ev
Mb
Qv
bs
Mb
Mb
uO
NI
Mb
Mb
Xy
Qv
tB
tB
Qv
lY
"}
(14,1,1) = {"
aJ
Qv
ev
Mb
Qv
mw
Mb
Mb
VV
Mb
Mb
Mb
AO
Qv
tB
tB
do
lY
"}
(15,1,1) = {"
aJ
Qv
Qv
Mb
Qv
Rd
vh
sO
Hk
ID
ot
jb
nd
bc
vo
hX
sz
lY
"}
(16,1,1) = {"
aJ
aJ
Qv
Qv
Qv
Qv
Qv
Qv
ec
ec
Qv
Qv
Qv
Qv
Qv
Qv
lY
aJ
"}
(17,1,1) = {"
aJ
aJ
Qv
QS
Qv
tB
nH
Qv
tB
tB
Qv
tB
nH
Qv
QS
Qv
IS
aJ
"}
(18,1,1) = {"
aJ
aJ
aJ
aJ
Qv
tB
tB
Qv
lx
lx
Qv
tB
tB
Qv
IS
IS
IS
aJ
"}
(19,1,1) = {"
aJ
aJ
aJ
aJ
aJ
aJ
lY
lY
lY
lY
lY
aJ
aJ
aJ
aJ
aJ
aJ
aJ
"}
