//MAP CONVERTED BY dmm2tgm.py THIS HEADER COMMENT PREVENTS RECONVERSION, DO NOT REMOVE
"a" = (
/turf/template_noop,
/area/template_noop)
"e" = (
/obj/effect/decal/cleanable/blood/old,
/turf/open/floor/engine,
/area/lavaland/surface/outdoors/unexplored)
"k" = (
/obj/structure/closet/crate,
/obj/item/stack/sheet/metal/fifty,
/obj/item/stack/rods/fifty,
/obj/item/stack/sheet/glass/fifty,
/obj/item/electronics/airlock,
/obj/item/electronics/airlock,
/obj/item/stock_parts/cell/high/plus,
/obj/item/lightreplacer,
/obj/item/lightreplacer,
/turf/open/floor/engine,
/area/lavaland/surface/outdoors/unexplored)
"m" = (
/obj/structure/trash_pile,
/obj/effect/decal/cleanable/dirt/dust,
/turf/open/floor/engine,
/area/lavaland/surface/outdoors/unexplored)
"p" = (
/obj/effect/decal/cleanable/dirt/dust,
/turf/open/floor/engine,
/area/lavaland/surface/outdoors/unexplored)
"q" = (
/obj/machinery/door/poddoor{
	name = "cargo pod"
	},
/turf/open/floor/engine,
/area/lavaland/surface/outdoors/unexplored)
"r" = (
/obj/structure/trash_pile,
/turf/open/floor/engine,
/area/lavaland/surface/outdoors/unexplored)
"D" = (
/obj/structure/closet/crate/solarpanel_small,
/obj/effect/decal/cleanable/dirt/dust,
/turf/open/floor/engine,
/area/lavaland/surface/outdoors/unexplored)
"E" = (
/obj/machinery/door/poddoor/preopen{
	name = "cargo pod"
	},
/obj/effect/decal/cleanable/blood/tracks{
	dir = 8
	},
/turf/open/floor/engine,
/area/lavaland/surface/outdoors/unexplored)
"F" = (
/obj/effect/decal/cleanable/blood/old,
/obj/effect/decal/cleanable/dirt/dust,
/turf/open/floor/engine,
/area/lavaland/surface/outdoors/unexplored)
"N" = (
/turf/open/floor/plating/asteroid/basalt/lava_land_surface,
/area/lavaland/surface/outdoors/unexplored)
"P" = (
/obj/effect/decal/cleanable/blood/tracks{
	dir = 8
	},
/turf/open/floor/plating/asteroid/basalt/lava_land_surface,
/area/lavaland/surface/outdoors/unexplored)
"Q" = (
/obj/effect/decal/cleanable/blood/tracks{
	dir = 8
	},
/turf/open/floor/engine,
/area/lavaland/surface/outdoors/unexplored)
"R" = (
/turf/closed/mineral/volcanic/lava_land_surface,
/area/lavaland/surface/outdoors/unexplored)
"U" = (
/turf/closed/wall/r_wall,
/area/lavaland/surface/outdoors/unexplored)
"W" = (
/obj/structure/reagent_dispensers/watertank,
/turf/open/floor/engine,
/area/lavaland/surface/outdoors/unexplored)
"Y" = (
/obj/effect/decal/cleanable/blood/tracks{
	dir = 8
	},
/obj/item/bikehorn,
/turf/open/floor/engine,
/area/lavaland/surface/outdoors/unexplored)
"Z" = (
/obj/structure/reagent_dispensers/fueltank,
/obj/effect/decal/cleanable/dirt/dust,
/turf/open/floor/engine,
/area/lavaland/surface/outdoors/unexplored)

(1,1,1) = {"
a
a
a
N
N
N
a
a
a
"}
(2,1,1) = {"
a
a
a
N
N
N
N
a
a
"}
(3,1,1) = {"
a
a
N
N
N
N
N
N
a
"}
(4,1,1) = {"
a
N
N
N
P
N
N
N
a
"}
(5,1,1) = {"
a
R
U
U
E
U
U
N
a
"}
(6,1,1) = {"
a
R
U
F
Q
r
U
N
a
"}
(7,1,1) = {"
R
R
U
p
Y
W
U
R
a
"}
(8,1,1) = {"
R
R
U
k
Q
p
U
R
R
"}
(9,1,1) = {"
R
R
U
m
p
e
U
R
R
"}
(10,1,1) = {"
R
R
U
Z
p
D
U
R
R
"}
(11,1,1) = {"
R
R
U
U
q
U
U
R
R
"}
(12,1,1) = {"
R
N
N
N
N
N
N
N
a
"}
(13,1,1) = {"
a
a
N
N
N
N
N
a
a
"}
(14,1,1) = {"
a
a
a
N
N
a
a
a
a
"}
