//MAP CONVERTED BY dmm2tgm.py THIS HEADER COMMENT PREVENTS RECONVERSION, DO NOT REMOVE
"a" = (
/turf/template_noop,
/area/template_noop)
"v" = (
/obj/effect/decal/cleanable/blood/gibs,
/turf/open/floor/plating/asteroid/basalt/lava_land_surface,
/area/lavaland/surface/outdoors/unexplored)
"A" = (
/obj/structure/bonfire,
/turf/open/floor/plating/asteroid/basalt/lava_land_surface,
/area/lavaland/surface/outdoors/unexplored)
"B" = (
/turf/closed/mineral/volcanic/lava_land_surface,
/area/lavaland/surface/outdoors/unexplored)
"E" = (
/turf/open/floor/plating/asteroid/basalt/lava_land_surface,
/area/lavaland/surface/outdoors/unexplored)
"K" = (
/obj/item/spear/bonespear,
/turf/open/floor/plating/asteroid/basalt/lava_land_surface,
/area/lavaland/surface/outdoors/unexplored)
"L" = (
/obj/item/kitchen/knife/combat/bone,
/turf/open/floor/plating/asteroid/basalt/lava_land_surface,
/area/lavaland/surface/outdoors/unexplored)

(1,1,1) = {"
a
E
E
E
E
B
a
"}
(2,1,1) = {"
E
E
v
E
E
B
B
"}
(3,1,1) = {"
E
E
v
v
E
E
B
"}
(4,1,1) = {"
B
K
E
E
E
E
B
"}
(5,1,1) = {"
B
E
E
A
E
E
B
"}
(6,1,1) = {"
B
E
E
E
L
E
B
"}
(7,1,1) = {"
B
B
E
E
E
E
B
"}
(8,1,1) = {"
a
B
B
E
E
B
a
"}
