//MAP CONVERTED BY dmm2tgm.py THIS HEADER COMMENT PREVENTS RECONVERSION, DO NOT REMOVE
"az" = (
/obj/machinery/door/airlock/external,
/obj/structure/fans/tiny,
/obj/effect/mapping_helpers/airlock/cyclelink_helper{
	dir = 8
	},
/turf/open/floor/plating,
/area/lavaland/surface/outdoors)
"bo" = (
/obj/structure/table/glass,
/obj/machinery/reagentgrinder{
	pixel_y = 5
	},
/obj/item/reagent_containers/glass/beaker/bluespace,
/obj/item/reagent_containers/glass/beaker/bluespace,
/obj/item/reagent_containers/glass/beaker/bluespace,
/obj/item/reagent_containers/glass/beaker/bluespace,
/turf/open/floor/plasteel/freezer,
/area/ruin/powered/seedvault)
"bZ" = (
/obj/machinery/vending/hydronutrients,
/turf/open/floor/plasteel/showroomfloor,
/area/ruin/powered/seedvault)
"ck" = (
/obj/structure/disposalpipe/segment,
/turf/closed/wall/r_wall,
/area/ruin/powered/seedvault)
"cv" = (
/obj/machinery/door/airlock/external,
/obj/effect/mapping_helpers/airlock/cyclelink_helper{
	dir = 4
	},
/turf/open/floor/plating,
/area/ruin/powered/seedvault)
"cE" = (
/turf/open/floor/plating,
/area/ruin/powered/seedvault)
"dD" = (
/obj/structure/sink{
	dir = 8;
	pixel_x = -12;
	pixel_y = 2
	},
/turf/open/floor/plasteel/freezer,
/area/ruin/powered/seedvault)
"hf" = (
/turf/open/floor/plasteel/showroomfloor,
/area/ruin/powered/seedvault)
"hr" = (
/obj/structure/disposalpipe/segment{
	dir = 5
	},
/turf/open/floor/plating,
/area/lavaland/surface/outdoors)
"hU" = (
/obj/machinery/chem_master/condimaster,
/turf/open/floor/plasteel/freezer,
/area/ruin/powered/seedvault)
"iH" = (
/turf/open/floor/plasteel/freezer,
/area/ruin/powered/seedvault)
"ja" = (
/obj/machinery/hydroponics/constructable,
/turf/open/floor/plasteel/showroomfloor,
/area/ruin/powered/seedvault)
"kc" = (
/obj/machinery/smartfridge,
/turf/open/floor/plasteel/freezer,
/area/ruin/powered/seedvault)
"kz" = (
/obj/structure/table/wood,
/obj/item/lighter,
/obj/item/lighter,
/obj/item/storage/fancy/rollingpapers,
/obj/item/storage/fancy/rollingpapers,
/obj/item/storage/fancy/rollingpapers,
/obj/item/storage/fancy/rollingpapers,
/turf/open/floor/plasteel/freezer,
/area/ruin/powered/seedvault)
"kE" = (
/obj/structure/shuttle/engine/propulsion{
	dir = 4
	},
/turf/open/floor/plating,
/area/lavaland/surface/outdoors)
"kI" = (
/obj/machinery/plantgenes/seedvault{
	pixel_y = 6
	},
/obj/structure/table/wood,
/turf/open/floor/plasteel/freezer,
/area/ruin/powered/seedvault)
"kW" = (
/obj/machinery/door/airlock,
/turf/open/floor/plasteel/freezer,
/area/ruin/powered/seedvault)
"mw" = (
/obj/machinery/hydroponics/constructable,
/turf/open/floor/plasteel/freezer,
/area/ruin/powered/seedvault)
"nG" = (
/obj/item/storage/toolbox/syndicate,
/obj/structure/table/wood,
/turf/open/floor/plasteel/freezer,
/area/ruin/powered/seedvault)
"pp" = (
/obj/machinery/disposal/bin,
/turf/open/floor/plasteel/showroomfloor,
/area/ruin/powered/seedvault)
"qJ" = (
/obj/machinery/seed_extractor,
/turf/open/floor/plasteel/showroomfloor,
/area/ruin/powered/seedvault)
"ry" = (
/obj/machinery/biogenerator,
/turf/open/floor/plasteel/showroomfloor,
/area/ruin/powered/seedvault)
"sp" = (
/obj/item/disk/design_disk/plant_disk,
/obj/machinery/autolathe/hacked{
	desc = "This autolathe seems to have its safety light off."
	},
/turf/open/floor/plasteel/freezer,
/area/ruin/powered/seedvault)
"sH" = (
/obj/machinery/light{
	dir = 1
	},
/turf/open/floor/plasteel/freezer,
/area/ruin/powered/seedvault)
"sI" = (
/obj/machinery/hydroponics/constructable,
/obj/machinery/light{
	dir = 1
	},
/turf/open/floor/plasteel/freezer,
/area/ruin/powered/seedvault)
"tF" = (
/turf/closed/mineral/volcanic/lava_land_surface,
/area/lavaland/surface/outdoors)
"tU" = (
/obj/structure/sink{
	dir = 4;
	pixel_x = 11
	},
/turf/open/floor/plasteel/freezer,
/area/ruin/powered/seedvault)
"uQ" = (
/obj/structure/closet/crate/hydroponics,
/obj/item/cultivator,
/obj/item/cultivator,
/obj/item/cultivator,
/obj/item/cultivator,
/obj/item/shovel/spade,
/obj/item/shovel/spade,
/obj/item/shovel/spade,
/obj/item/shovel/spade,
/obj/item/hatchet,
/obj/item/hatchet,
/obj/item/hatchet,
/obj/item/hatchet,
/turf/open/floor/plasteel/freezer,
/area/ruin/powered/seedvault)
"vV" = (
/obj/structure/disposalpipe/trunk{
	dir = 8
	},
/turf/open/floor/plating,
/area/lavaland/surface/outdoors)
"vX" = (
/obj/machinery/chem_dispenser/mutagensaltpeter,
/turf/open/floor/plasteel/showroomfloor,
/area/ruin/powered/seedvault)
"wU" = (
/obj/machinery/hydroponics/constructable,
/obj/machinery/light,
/turf/open/floor/plasteel/freezer,
/area/ruin/powered/seedvault)
"ys" = (
/obj/machinery/light,
/turf/open/floor/plasteel/freezer,
/area/ruin/powered/seedvault)
"DN" = (
/obj/structure/table/wood,
/obj/item/gun/energy/floragun,
/obj/item/gun/energy/floragun,
/obj/item/gun/energy/floragun,
/obj/item/gun/energy/floragun,
/obj/item/storage/box/disks_plantgene,
/turf/open/floor/plasteel/freezer,
/area/ruin/powered/seedvault)
"Ez" = (
/obj/structure/shuttle/engine/large{
	dir = 4
	},
/turf/open/floor/plating,
/area/lavaland/surface/outdoors)
"FU" = (
/turf/open/floor/plating/asteroid/basalt/lava_land_surface,
/area/lavaland/surface/outdoors)
"GN" = (
/obj/machinery/smartfridge,
/turf/open/floor/plasteel/showroomfloor,
/area/ruin/powered/seedvault)
"HF" = (
/obj/machinery/vending/hydroseeds,
/turf/open/floor/plasteel/showroomfloor,
/area/ruin/powered/seedvault)
"Jq" = (
/obj/structure/table/wood,
/obj/item/storage/box/disks_plantgene,
/obj/machinery/light{
	dir = 1
	},
/turf/open/floor/plasteel/freezer,
/area/ruin/powered/seedvault)
"Lh" = (
/turf/closed/wall/r_wall,
/area/ruin/powered/seedvault)
"Ll" = (
/obj/effect/mob_spawn/human/seed_vault,
/turf/open/floor/plasteel/freezer,
/area/ruin/powered/seedvault)
"Ns" = (
/obj/structure/closet/crate/hydroponics,
/obj/structure/beebox,
/obj/item/melee/flyswatter,
/obj/item/honey_frame,
/obj/item/honey_frame,
/obj/item/honey_frame,
/obj/item/queen_bee/bought,
/obj/item/clothing/head/beekeeper_head,
/obj/item/clothing/suit/beekeeper_suit,
/turf/open/floor/plasteel/freezer,
/area/ruin/powered/seedvault)
"Ol" = (
/obj/machinery/light{
	dir = 8
	},
/turf/open/floor/plasteel/freezer,
/area/ruin/powered/seedvault)
"Or" = (
/obj/structure/table/wood,
/obj/item/storage/box/disks_plantgene,
/turf/open/floor/plasteel/freezer,
/area/ruin/powered/seedvault)
"Qf" = (
/turf/open/floor/plating,
/area/lavaland/surface/outdoors)
"RO" = (
/obj/structure/disposalpipe/segment,
/turf/open/floor/plasteel/freezer,
/area/ruin/powered/seedvault)
"SY" = (
/obj/structure/table/wood,
/obj/item/reagent_containers/glass/bucket,
/obj/item/reagent_containers/glass/bucket,
/obj/item/reagent_containers/glass/bucket,
/obj/item/reagent_containers/glass/bucket,
/turf/open/floor/plasteel/freezer,
/area/ruin/powered/seedvault)
"Vw" = (
/obj/item/hatchet,
/obj/item/storage/bag/plants,
/obj/item/reagent_containers/glass/bucket,
/obj/structure/table/wood,
/turf/open/floor/plasteel/freezer,
/area/ruin/powered/seedvault)
"Wb" = (
/obj/machinery/light{
	dir = 4
	},
/turf/open/floor/plasteel/freezer,
/area/ruin/powered/seedvault)
"Xw" = (
/obj/structure/closet/crate,
/obj/effect/spawner/lootdrop/seed_vault,
/turf/open/floor/plasteel/freezer,
/area/ruin/powered/seedvault)
"XV" = (
/obj/structure/closet/crate/hydroponics,
/obj/item/clothing/under/rank/civilian/hydroponics,
/obj/item/clothing/under/rank/civilian/hydroponics,
/obj/item/clothing/under/rank/civilian/hydroponics,
/obj/item/clothing/under/rank/civilian/hydroponics,
/turf/open/floor/plasteel/freezer,
/area/ruin/powered/seedvault)
"YY" = (
/obj/structure/table/wood,
/obj/machinery/smartfridge/disks{
	pixel_y = 2
	},
/turf/open/floor/plasteel/freezer,
/area/ruin/powered/seedvault)
"Zq" = (
/obj/machinery/light{
	dir = 4
	},
/obj/item/storage/bag/plants,
/obj/item/storage/bag/plants,
/obj/item/storage/bag/plants,
/obj/item/storage/bag/plants,
/turf/open/floor/plasteel/freezer,
/area/ruin/powered/seedvault)
"ZR" = (
/turf/closed/wall/r_wall,
/area/lavaland/surface/outdoors)

(1,1,1) = {"
tF
tF
tF
tF
tF
tF
tF
Lh
Lh
Lh
Lh
Lh
Lh
tF
tF
tF
tF
tF
FU
FU
"}
(2,1,1) = {"
tF
tF
tF
tF
tF
tF
ZR
Lh
Ll
Ll
Ll
Ll
Lh
ZR
tF
tF
tF
tF
FU
FU
"}
(3,1,1) = {"
FU
tF
tF
tF
tF
tF
Lh
Lh
sH
iH
iH
ys
Lh
Lh
tF
tF
tF
FU
tF
FU
"}
(4,1,1) = {"
FU
tF
tF
Lh
Lh
Lh
Lh
Lh
Lh
kW
kW
Lh
Lh
Lh
Lh
ZR
ZR
tF
tF
tF
"}
(5,1,1) = {"
tF
tF
Lh
Lh
Xw
Lh
kc
Ol
dD
iH
iH
dD
Ol
sp
Lh
Qf
ZR
ZR
tF
tF
"}
(6,1,1) = {"
tF
tF
Lh
kz
iH
Lh
uQ
iH
iH
iH
iH
iH
iH
XV
Lh
Qf
Qf
ZR
tF
tF
"}
(7,1,1) = {"
tF
tF
Lh
Jq
iH
Lh
sI
iH
iH
bZ
HF
iH
iH
ys
Lh
Qf
Qf
ZR
tF
tF
"}
(8,1,1) = {"
FU
tF
Lh
Or
iH
kW
iH
iH
iH
qJ
ry
iH
RO
RO
ck
hr
Qf
ZR
tF
tF
"}
(9,1,1) = {"
FU
tF
Lh
kI
iH
Lh
mw
iH
iH
hf
hf
iH
iH
Xw
Lh
vV
Qf
ZR
tF
tF
"}
(10,1,1) = {"
tF
tF
Lh
YY
iH
Lh
mw
iH
iH
hf
hf
iH
iH
mw
Lh
Qf
Qf
ZR
tF
tF
"}
(11,1,1) = {"
tF
tF
Lh
iH
iH
Lh
Vw
iH
iH
hf
hf
iH
iH
mw
Lh
Qf
Qf
ZR
tF
tF
"}
(12,1,1) = {"
FU
tF
Lh
sH
iH
Lh
sH
iH
iH
GN
ja
iH
iH
wU
Lh
Qf
Qf
ZR
tF
tF
"}
(13,1,1) = {"
tF
tF
Lh
iH
iH
Lh
hU
iH
iH
pp
vX
iH
iH
iH
Lh
Qf
Qf
ZR
FU
tF
"}
(14,1,1) = {"
tF
tF
Lh
Ns
iH
Lh
bo
iH
iH
iH
iH
iH
iH
SY
Lh
Qf
Qf
FU
FU
tF
"}
(15,1,1) = {"
tF
tF
ZR
Lh
Ns
Lh
DN
Zq
tU
iH
iH
tU
Wb
nG
Lh
Qf
ZR
FU
FU
FU
"}
(16,1,1) = {"
FU
tF
FU
ZR
Lh
ZR
Lh
ZR
Lh
cv
cv
Lh
ZR
Lh
ZR
ZR
ZR
FU
FU
FU
"}
(17,1,1) = {"
tF
tF
FU
ZR
kE
ZR
Qf
Ez
Lh
cE
cE
Lh
Qf
Ez
ZR
kE
ZR
tF
FU
FU
"}
(18,1,1) = {"
tF
tF
tF
tF
tF
ZR
Qf
Qf
ZR
az
az
ZR
Qf
Qf
ZR
tF
tF
tF
FU
FU
"}
(19,1,1) = {"
tF
tF
tF
tF
FU
FU
tF
FU
FU
FU
FU
FU
FU
FU
tF
tF
tF
FU
FU
FU
"}
(20,1,1) = {"
tF
tF
tF
FU
FU
FU
tF
FU
FU
FU
FU
FU
FU
FU
tF
tF
tF
FU
FU
tF
"}
