//MAP CONVERTED BY dmm2tgm.py THIS HEADER COMMENT PREVENTS RECONVERSION, DO NOT REMOVE
"a" = (
/turf/template_noop,
/area/template_noop)
"d" = (
/obj/structure/flora/tree/jungle,
/turf/open/floor/plating/smooth/grass/lavaland_jungle,
/area/lavaland/surface/outdoors)
"i" = (
/turf/open/floor/plating/smooth/grass/lavaland_jungle,
/area/lavaland/surface/outdoors)
"k" = (
/obj/structure/flora/junglebush/large,
/turf/open/floor/plating/smooth/grass/lavaland_jungle,
/area/lavaland/surface/outdoors)
"l" = (
/obj/structure/flora/ausbushes/fernybush,
/turf/open/floor/plating/smooth/grass/lavaland_jungle,
/area/lavaland/surface/outdoors)
"o" = (
/obj/structure/flora/ausbushes/grassybush,
/turf/open/floor/plating/smooth/grass/lavaland_jungle,
/area/lavaland/surface/outdoors)
"r" = (
/obj/structure/flora/junglebush,
/turf/open/floor/plating/smooth/grass/lavaland_jungle,
/area/lavaland/surface/outdoors)
"s" = (
/obj/structure/flora/ausbushes/ywflowers,
/turf/open/floor/plating/smooth/grass/lavaland_jungle,
/area/lavaland/surface/outdoors)
"t" = (
/obj/structure/flora/ausbushes/ppflowers,
/turf/open/floor/plating/smooth/grass/lavaland_jungle,
/area/lavaland/surface/outdoors)
"u" = (
/obj/structure/flora/ausbushes/stalkybush,
/turf/open/floor/plating/smooth/grass/lavaland_jungle,
/area/lavaland/surface/outdoors)
"A" = (
/obj/structure/flora/ausbushes/brflowers,
/turf/open/floor/plating/smooth/grass/lavaland_jungle,
/area/lavaland/surface/outdoors)
"D" = (
/obj/structure/flora/tree/jungle/small,
/turf/open/floor/plating/smooth/grass/lavaland_jungle,
/area/lavaland/surface/outdoors)
"G" = (
/obj/structure/flora/ausbushes/palebush,
/turf/open/floor/plating/smooth/grass/lavaland_jungle,
/area/lavaland/surface/outdoors)
"H" = (
/obj/structure/flora/grass/jungle,
/turf/open/floor/plating/smooth/grass/lavaland_jungle,
/area/lavaland/surface/outdoors)
"I" = (
/obj/structure/flora/ausbushes/pointybush,
/turf/open/floor/plating/smooth/grass/lavaland_jungle,
/area/lavaland/surface/outdoors)
"L" = (
/obj/structure/flora/grass/jungle/b,
/turf/open/floor/plating/smooth/grass/lavaland_jungle,
/area/lavaland/surface/outdoors)
"P" = (
/turf/open/water/lavaland_jungle,
/area/lavaland/surface/outdoors)
"Q" = (
/obj/structure/flora/ausbushes/reedbush,
/turf/open/floor/plating/smooth/grass/lavaland_jungle,
/area/lavaland/surface/outdoors)
"X" = (
/obj/structure/flora/biolumi,
/turf/open/floor/plating/smooth/grass/lavaland_jungle,
/area/lavaland/surface/outdoors)

(1,1,1) = {"
a
a
a
i
i
i
a
a
a
a
a
"}
(2,1,1) = {"
a
a
i
i
d
s
i
i
D
a
a
"}
(3,1,1) = {"
a
i
i
i
i
i
P
P
Q
i
a
"}
(4,1,1) = {"
i
i
t
i
H
P
P
P
P
I
a
"}
(5,1,1) = {"
i
i
i
r
P
P
P
P
P
i
i
"}
(6,1,1) = {"
i
i
d
P
P
P
P
P
P
i
i
"}
(7,1,1) = {"
i
i
i
P
P
P
P
P
G
u
i
"}
(8,1,1) = {"
a
o
i
X
P
P
P
i
A
i
i
"}
(9,1,1) = {"
a
i
D
l
i
L
i
i
i
d
i
"}
(10,1,1) = {"
i
i
i
i
k
i
i
i
i
i
a
"}
(11,1,1) = {"
a
i
i
i
i
a
a
a
i
a
a
"}
(12,1,1) = {"
a
a
a
a
a
a
a
a
a
a
a
"}
