//MAP CONVERTED BY dmm2tgm.py THIS HEADER COMMENT PREVENTS RECONVERSION, DO NOT REMOVE
"bj" = (
/obj/effect/turf_decal/tile/red{
	dir = 1
	},
/obj/effect/turf_decal/tile/red{
	dir = 4
	},
/obj/effect/mob_spawn/human/corpse/russian,
/turf/open/floor/plasteel/dark,
/area/ruin/unpowered)
"ch" = (
/obj/effect/turf_decal/tile/red{
	dir = 1
	},
/obj/effect/turf_decal/tile/red{
	dir = 8
	},
/obj/effect/turf_decal/tile/red{
	dir = 4
	},
/obj/structure/chair/comfy/shuttle{
	dir = 4
	},
/turf/open/floor/plasteel/dark,
/area/ruin/unpowered)
"cp" = (
/turf/open/floor/mineral/plastitanium/red/brig,
/area/ruin/unpowered)
"cR" = (
/obj/structure/shuttle/engine/propulsion{
	dir = 8
	},
/turf/open/floor/plating,
/area/ruin/unpowered)
"cT" = (
/obj/effect/decal/cleanable/blood/tracks,
/turf/open/floor/mineral/plastitanium/red/brig,
/area/ruin/unpowered)
"cU" = (
/obj/effect/decal/cleanable/vomit/old,
/turf/open/floor/plasteel/dark,
/area/ruin/unpowered)
"dr" = (
/obj/structure/grille,
/obj/structure/window/plastitanium,
/turf/open/floor/plating,
/area/ruin/unpowered)
"eN" = (
/obj/structure/shuttle/engine/large{
	dir = 8
	},
/turf/open/floor/plating,
/area/ruin/unpowered)
"fj" = (
/obj/effect/turf_decal/tile/red{
	dir = 1
	},
/obj/effect/turf_decal/tile/red{
	dir = 8
	},
/obj/structure/chair/comfy/shuttle{
	dir = 4
	},
/turf/open/floor/plasteel/dark,
/area/ruin/unpowered)
"gi" = (
/obj/machinery/door/airlock/grunge{
	name = "Barrack";
	req_one_access_txt = "19"
	},
/turf/open/floor/mineral/plastitanium,
/area/ruin/unpowered)
"go" = (
/obj/effect/decal/cleanable/blood/drip,
/turf/open/floor/mineral/plastitanium,
/area/ruin/unpowered)
"gB" = (
/obj/structure/window/reinforced{
	dir = 1
	},
/obj/structure/table/reinforced,
/obj/item/storage/firstaid/fire,
/turf/open/floor/mineral/titanium/white,
/area/ruin/unpowered)
"hk" = (
/obj/structure/tank_dispenser,
/turf/open/floor/plasteel/dark,
/area/ruin/unpowered)
"jU" = (
/obj/structure/table/reinforced,
/turf/open/floor/mineral/plastitanium,
/area/ruin/unpowered)
"kC" = (
/obj/structure/window/reinforced{
	dir = 4
	},
/obj/structure/shuttle/engine/heater{
	dir = 8
	},
/turf/open/floor/plating,
/area/ruin/unpowered)
"mk" = (
/obj/structure/table/reinforced,
/obj/item/storage/backpack/duffelbag/med/surgery{
	pixel_y = 4
	},
/turf/open/floor/mineral/titanium/white,
/area/ruin/unpowered)
"nh" = (
/obj/effect/turf_decal/tile/red{
	dir = 8
	},
/obj/effect/turf_decal/tile/red,
/obj/effect/turf_decal/tile/red{
	dir = 4
	},
/obj/structure/chair/comfy/shuttle{
	dir = 8
	},
/turf/open/floor/plasteel/dark,
/area/ruin/unpowered)
"nR" = (
/obj/effect/decal/cleanable/blood/tracks{
	dir = 4
	},
/turf/open/floor/plating,
/area/ruin/unpowered)
"oB" = (
/obj/effect/turf_decal/tile/red{
	dir = 8
	},
/obj/effect/turf_decal/tile/red,
/turf/open/floor/plasteel/dark,
/area/ruin/unpowered)
"oU" = (
/obj/effect/turf_decal/tile/red{
	dir = 8
	},
/obj/effect/turf_decal/tile/red,
/obj/effect/turf_decal/tile/red{
	dir = 1
	},
/obj/structure/chair/comfy/shuttle{
	dir = 4
	},
/turf/open/floor/plasteel/dark,
/area/ruin/unpowered)
"pA" = (
/obj/machinery/door/airlock/external,
/obj/effect/mapping_helpers/airlock/cyclelink_helper{
	dir = 1
	},
/obj/effect/decal/cleanable/blood/tracks,
/turf/open/floor/plating,
/area/ruin/unpowered)
"pC" = (
/obj/structure/rack,
/obj/item/storage/box/handcuffs{
	pixel_x = -1;
	pixel_y = 1
	},
/obj/item/storage/box/handcuffs{
	pixel_x = 1;
	pixel_y = -1
	},
/obj/effect/decal/cleanable/cobweb,
/turf/open/floor/plasteel/dark,
/area/ruin/unpowered)
"pJ" = (
/obj/structure/chair/comfy/shuttle{
	dir = 4;
	name = "tactical chair"
	},
/turf/open/floor/mineral/plastitanium,
/area/ruin/unpowered)
"qs" = (
/turf/closed/wall/mineral/plastitanium,
/area/ruin/unpowered)
"qA" = (
/turf/closed/wall/mineral/plastitanium/nodiagonal,
/area/ruin/unpowered)
"qD" = (
/obj/effect/turf_decal/tile/red{
	dir = 8
	},
/obj/effect/turf_decal/tile/red,
/obj/effect/mob_spawn/human/corpse/russian,
/obj/effect/decal/cleanable/blood/old,
/turf/open/floor/plasteel/dark,
/area/ruin/unpowered)
"so" = (
/obj/effect/decal/cleanable/blood/tracks{
	dir = 9
	},
/turf/open/floor/plating,
/area/ruin/unpowered)
"xY" = (
/obj/effect/decal/cleanable/glass,
/turf/open/floor/mineral/plastitanium,
/area/ruin/unpowered)
"yb" = (
/obj/machinery/computer/crew{
	dir = 8
	},
/turf/open/floor/plating,
/area/ruin/unpowered)
"yu" = (
/obj/effect/decal/cleanable/glass,
/turf/open/floor/mineral/plastitanium/red/brig,
/area/ruin/unpowered)
"yx" = (
/obj/structure/window/reinforced{
	dir = 1
	},
/obj/structure/fluff/empty_sleeper{
	dir = 4
	},
/turf/open/floor/mineral/titanium/white,
/area/ruin/unpowered)
"zd" = (
/mob/living/simple_animal/bot/medbot{
	name = "old medibot"
	},
/obj/effect/turf_decal/bot,
/turf/open/floor/mineral/titanium/white,
/area/ruin/unpowered)
"zZ" = (
/obj/machinery/door/airlock/external,
/obj/effect/mapping_helpers/airlock/cyclelink_helper{
	dir = 1
	},
/turf/open/floor/plating,
/area/ruin/unpowered)
"Bf" = (
/turf/template_noop,
/area/template_noop)
"Bl" = (
/obj/effect/mob_spawn/human/corpse/assistant,
/obj/effect/decal/cleanable/blood/old,
/turf/open/floor/plating,
/area/ruin/unpowered)
"BA" = (
/obj/structure/chair/comfy/shuttle{
	dir = 4;
	name = "tactical chair"
	},
/turf/open/floor/plating,
/area/ruin/unpowered)
"BO" = (
/turf/open/floor/mineral/plastitanium,
/area/ruin/unpowered)
"Ci" = (
/obj/effect/decal/cleanable/blood/tracks{
	dir = 6
	},
/turf/open/floor/mineral/titanium/white,
/area/ruin/unpowered)
"CO" = (
/obj/machinery/door/airlock/security/glass{
	name = "Holding Area";
	req_one_access_txt = "19"
	},
/turf/open/floor/mineral/plastitanium,
/area/ruin/unpowered)
"CP" = (
/obj/effect/decal/cleanable/blood/drip,
/turf/open/floor/plating,
/area/ruin/unpowered)
"Dr" = (
/obj/structure/table/reinforced,
/obj/item/storage/firstaid/tactical,
/obj/item/defibrillator/loaded,
/turf/open/floor/mineral/titanium/white,
/area/ruin/unpowered)
"Eq" = (
/obj/structure/window/reinforced,
/turf/open/floor/plasteel/dark,
/area/ruin/unpowered)
"EF" = (
/obj/effect/decal/cleanable/generic,
/turf/open/floor/mineral/plastitanium,
/area/ruin/unpowered)
"EW" = (
/obj/structure/window/plastitanium,
/turf/open/floor/plating,
/area/ruin/unpowered)
"Fr" = (
/turf/open/floor/plating,
/area/ruin/unpowered)
"Gg" = (
/obj/structure/window/reinforced,
/obj/effect/mob_spawn/human/corpse/assistant,
/obj/effect/decal/cleanable/blood/old,
/turf/open/floor/plasteel/dark,
/area/ruin/unpowered)
"GM" = (
/turf/open/floor/plating/asteroid/snow/icemoon,
/area/icemoon/surface/outdoors)
"GV" = (
/obj/effect/decal/cleanable/blood/tracks{
	dir = 5
	},
/turf/open/floor/plating/asteroid/snow/icemoon,
/area/icemoon/surface/outdoors)
"Ho" = (
/obj/machinery/door/airlock/external,
/obj/effect/mapping_helpers/airlock/cyclelink_helper,
/obj/effect/decal/cleanable/blood/tracks,
/turf/open/floor/plating,
/area/ruin/unpowered)
"JH" = (
/turf/open/floor/plating/asteroid/snow/icemoon,
/area/ruin/unpowered)
"Kf" = (
/obj/structure/table/optable,
/turf/open/floor/mineral/titanium/white,
/area/ruin/unpowered)
"Ld" = (
/obj/machinery/computer/operating{
	dir = 1
	},
/turf/open/floor/mineral/titanium/white,
/area/ruin/unpowered)
"Md" = (
/obj/effect/turf_decal/tile/red{
	dir = 1
	},
/obj/effect/turf_decal/tile/red{
	dir = 4
	},
/turf/open/floor/plasteel/dark,
/area/ruin/unpowered)
"MZ" = (
/turf/open/floor/mineral/titanium/white,
/area/ruin/unpowered)
"NA" = (
/obj/effect/decal/cleanable/blood/tracks{
	dir = 4
	},
/turf/open/floor/plating/asteroid/snow/icemoon,
/area/icemoon/surface/outdoors)
"OC" = (
/obj/structure/window/reinforced{
	dir = 1
	},
/turf/open/floor/mineral/titanium/white,
/area/ruin/unpowered)
"OV" = (
/obj/effect/decal/cleanable/blood/drip,
/turf/open/floor/plasteel,
/area/ruin/unpowered)
"OX" = (
/obj/structure/bed,
/obj/item/bedsheet/hos{
	desc = "A basic military blanket, for long military treks.";
	name = "military thermo-cover"
	},
/turf/open/floor/plasteel,
/area/ruin/unpowered)
"Pa" = (
/obj/effect/decal/remains/human,
/turf/open/floor/mineral/plastitanium/red/brig,
/area/ruin/unpowered)
"Pi" = (
/turf/closed/mineral/random/snow/no_caves,
/area/icemoon/underground/explored)
"Po" = (
/obj/structure/fluff/empty_sleeper{
	dir = 4
	},
/turf/open/floor/mineral/titanium/white,
/area/ruin/unpowered)
"QM" = (
/obj/effect/turf_decal/tile/red,
/obj/effect/turf_decal/tile/red{
	dir = 1
	},
/obj/effect/turf_decal/tile/red{
	dir = 4
	},
/obj/structure/chair/comfy/shuttle{
	dir = 8
	},
/obj/effect/mob_spawn/human/corpse/russian,
/obj/effect/decal/cleanable/blood/old,
/turf/open/floor/plasteel/dark,
/area/ruin/unpowered)
"Rl" = (
/obj/structure/rack,
/turf/open/floor/plasteel/dark,
/area/ruin/unpowered)
"RS" = (
/turf/open/floor/plasteel/dark,
/area/ruin/unpowered)
"Tr" = (
/obj/effect/decal/cleanable/glass,
/turf/open/floor/plating/asteroid/snow/icemoon,
/area/ruin/unpowered)
"Ut" = (
/obj/machinery/door/airlock/external,
/obj/effect/mapping_helpers/airlock/cyclelink_helper,
/turf/open/floor/plating,
/area/ruin/unpowered)
"Uw" = (
/obj/structure/chair/comfy/shuttle{
	dir = 4;
	name = "tactical chair"
	},
/obj/effect/decal/cleanable/glass,
/turf/open/floor/mineral/plastitanium,
/area/ruin/unpowered)
"Ux" = (
/obj/structure/closet/crate/secure/loot,
/turf/open/floor/plasteel/dark,
/area/ruin/unpowered)
"Vq" = (
/obj/structure/bed,
/obj/item/bedsheet/captain{
	desc = "A basic military blanket, for long military treks. This one belongs to a Nanotrasen Naval Captain.";
	name = "captain's thermo-cover"
	},
/turf/open/floor/plasteel,
/area/ruin/unpowered)
"Wk" = (
/obj/effect/decal/cleanable/shreds,
/turf/open/floor/mineral/plastitanium,
/area/ruin/unpowered)
"XE" = (
/turf/open/floor/plasteel,
/area/ruin/unpowered)
"XK" = (
/obj/effect/turf_decal/tile/red{
	dir = 8
	},
/obj/effect/turf_decal/tile/red,
/obj/effect/decal/cleanable/blood/old,
/turf/open/floor/plasteel/dark,
/area/ruin/unpowered)
"XN" = (
/obj/effect/decal/cleanable/blood/tracks,
/turf/open/floor/plating,
/area/ruin/unpowered)
"Yh" = (
/obj/effect/turf_decal/tile/red,
/obj/effect/turf_decal/tile/red{
	dir = 4
	},
/obj/structure/chair/comfy/shuttle{
	dir = 8
	},
/turf/open/floor/plasteel/dark,
/area/ruin/unpowered)
"Yk" = (
/obj/structure/window/reinforced,
/obj/structure/rack,
/turf/open/floor/plasteel/dark,
/area/ruin/unpowered)
"Yr" = (
/obj/effect/decal/cleanable/blood/old,
/turf/open/floor/plasteel,
/area/ruin/unpowered)
"Zx" = (
/obj/structure/window/reinforced{
	dir = 4
	},
/turf/open/floor/plating,
/area/ruin/unpowered)

(1,1,1) = {"
Bf
Bf
Bf
Bf
GM
GM
GM
GM
GM
GM
GM
GM
GM
GM
GM
GM
GM
Bf
Bf
Bf
"}
(2,1,1) = {"
Bf
Bf
Bf
GM
GM
GM
qs
GM
GM
GM
GM
GM
GM
GM
qs
GM
GM
GM
Bf
Bf
"}
(3,1,1) = {"
Bf
Bf
Bf
GM
GM
qs
qs
Fr
eN
cR
qA
cR
Fr
eN
qs
qs
GM
GM
Bf
Bf
"}
(4,1,1) = {"
Bf
Bf
GM
GM
qs
qs
qs
Zx
Zx
kC
qA
kC
Zx
Zx
qs
qs
qs
GM
Bf
Bf
"}
(5,1,1) = {"
Bf
Bf
GM
GM
qs
qs
Rl
Rl
Eq
BO
go
BO
yx
Po
Dr
qs
qs
GM
Bf
Bf
"}
(6,1,1) = {"
Bf
Bf
GM
GM
qs
pC
RS
RS
Gg
BO
BO
BO
OC
Fr
Bl
MZ
qs
GM
Bf
Bf
"}
(7,1,1) = {"
Bf
Bf
GM
GM
qs
Rl
Rl
hk
RS
BO
BO
BO
MZ
CP
nR
mk
qs
GM
Bf
Bf
"}
(8,1,1) = {"
Bf
GM
GM
GM
qs
Ux
RS
RS
RS
BO
BO
so
XN
XN
Ci
Kf
qs
GM
Bf
Bf
"}
(9,1,1) = {"
Bf
GM
GM
GM
qs
qA
Rl
Rl
Yk
BO
BO
nR
gB
zd
MZ
Ld
qs
GM
Bf
Bf
"}
(10,1,1) = {"
Bf
GM
GM
GM
qs
qA
qA
qA
qA
BO
BO
nR
qA
qA
qA
qA
qs
GM
Bf
Bf
"}
(11,1,1) = {"
Bf
GM
GM
GM
qs
OX
OX
OX
qA
EF
Fr
Fr
EW
ch
fj
oU
qs
GM
Bf
Bf
"}
(12,1,1) = {"
Bf
GM
GM
GM
qs
XE
XE
Yr
qA
Fr
Fr
Fr
EW
bj
cU
oB
qs
GM
Bf
Bf
"}
(13,1,1) = {"
Bf
Bf
GM
GM
qs
XE
OV
XE
gi
Fr
Fr
Fr
CO
Md
RS
XK
qs
GM
Bf
Bf
"}
(14,1,1) = {"
Bf
Pi
GM
GM
qs
XE
OV
XE
qA
Fr
Fr
Fr
EW
Md
RS
qD
qs
Pi
Bf
Bf
"}
(15,1,1) = {"
Pi
Pi
GM
NA
qs
Vq
OX
OX
qA
BO
Fr
BO
EW
QM
Yh
nh
qs
Pi
Bf
Bf
"}
(16,1,1) = {"
Pi
Pi
GM
NA
qs
qA
qA
qA
qA
BO
Fr
BO
qA
qA
qA
qA
qs
Pi
Bf
Bf
"}
(17,1,1) = {"
Pi
Pi
GM
GV
Ho
XN
pA
cT
cT
BO
BO
BO
cp
cp
Ut
Fr
zZ
Pi
Pi
Bf
"}
(18,1,1) = {"
Pi
Pi
Pi
GM
qs
qA
qA
cp
cp
Wk
BO
BO
cp
cp
qA
qA
qs
Pi
Pi
Bf
"}
(19,1,1) = {"
Pi
Pi
Pi
GM
Fr
Tr
JH
cp
yu
pJ
BO
pJ
Pa
cp
cp
cp
dr
Pi
Pi
Pi
"}
(20,1,1) = {"
Pi
Pi
Pi
GM
EW
JH
BO
cp
Pa
Uw
BO
pJ
yu
cp
BO
BO
dr
Pi
Pi
Pi
"}
(21,1,1) = {"
Pi
Pi
Pi
GM
qs
qs
jU
BO
Pi
pJ
BO
BA
yu
xY
jU
qs
qs
Pi
Pi
Pi
"}
(22,1,1) = {"
Pi
Pi
Pi
GM
qs
qs
qs
BO
Pi
Pi
qA
JH
yb
BO
qs
qs
qs
Pi
Pi
Pi
"}
(23,1,1) = {"
Bf
Pi
Pi
Pi
Pi
Pi
qs
EW
Pi
Pi
qs
Pi
Pi
dr
qs
qs
Pi
Pi
Pi
Pi
"}
(24,1,1) = {"
Bf
Pi
Pi
Pi
Pi
Pi
Pi
Pi
Pi
Pi
Pi
Pi
Pi
Pi
qs
Pi
Pi
Pi
Pi
Pi
"}
(25,1,1) = {"
Bf
Bf
Bf
Pi
Pi
Pi
Pi
Pi
Pi
Pi
Pi
Pi
Pi
Pi
Pi
Pi
Pi
Pi
Pi
Bf
"}
