//MAP CONVERTED BY dmm2tgm.py THIS HEADER COMMENT PREVENTS RECONVERSION, DO NOT REMOVE
"aw" = (
/obj/effect/decal/cleanable/dirt,
/turf/open/floor/plasteel/cafeteria,
/area/ruin/powered/truckstop)
"ay" = (
/turf/closed/mineral/random/snow/more_caves,
/area/icemoon/surface/outdoors)
"az" = (
/obj/machinery/light/small{
	dir = 8
	},
/turf/open/floor/plasteel/showroomfloor,
/area/ruin/powered/truckstop)
"aE" = (
/obj/effect/turf_decal/tile/bar,
/obj/effect/turf_decal/tile/bar{
	dir = 1
	},
/obj/item/cigbutt,
/turf/open/floor/plasteel,
/area/ruin/powered/truckstop)
"aW" = (
/obj/machinery/atmospherics/pipe/simple/supply/hidden/layer3{
	dir = 9
	},
/obj/machinery/atmospherics/pipe/simple/scrubbers/hidden/layer1{
	dir = 9
	},
/obj/structure/rack,
/obj/item/toy/plush/lizardplushie{
	pixel_x = -8
	},
/obj/item/toy/plush/lizardplushie{
	pixel_x = 8
	},
/turf/open/floor/plasteel,
/area/ruin/powered/truckstop)
"ds" = (
/obj/structure/rack,
/obj/item/reagent_containers/food/snacks/customizable/bread,
/obj/item/reagent_containers/food/snacks/customizable/bread{
	pixel_x = 5;
	pixel_y = -4
	},
/turf/open/floor/plasteel/cafeteria,
/area/ruin/powered/truckstop)
"dx" = (
/obj/machinery/atmospherics/pipe/simple/supply/hidden/layer3{
	dir = 10
	},
/obj/machinery/atmospherics/pipe/simple/scrubbers/hidden/layer1{
	dir = 10
	},
/turf/open/floor/plasteel/grimy,
/area/ruin/powered/truckstop)
"dB" = (
/obj/structure/rack,
/obj/item/storage/pill_bottle/dice{
	pixel_x = 6
	},
/obj/item/storage/pill_bottle/dice,
/obj/item/storage/pill_bottle/dice{
	pixel_x = -6
	},
/turf/open/floor/plasteel/cafeteria,
/area/ruin/powered/truckstop)
"ec" = (
/obj/machinery/atmospherics/pipe/manifold/supply/hidden/layer3{
	dir = 8
	},
/obj/machinery/atmospherics/pipe/simple/scrubbers/hidden/layer1,
/turf/open/floor/plasteel,
/area/ruin/powered/truckstop)
"eh" = (
/turf/open/floor/wood{
	icon_state = "wood-broken7"
	},
/area/ruin/powered/truckstop)
"eo" = (
/obj/machinery/light{
	dir = 8
	},
/turf/open/floor/plasteel,
/area/ruin/powered/truckstop)
"fi" = (
/obj/machinery/door/airlock{
	name = "Back Room"
	},
/obj/machinery/atmospherics/pipe/simple/supply/hidden/layer3{
	dir = 4
	},
/obj/machinery/atmospherics/pipe/simple/scrubbers/hidden/layer1{
	dir = 4
	},
/turf/open/floor/plasteel,
/area/ruin/powered/truckstop)
"fr" = (
/obj/machinery/atmospherics/pipe/simple/scrubbers/hidden/layer1,
/obj/structure/rack,
/obj/item/toy/seashell,
/obj/item/toy/tennis/yellow,
/obj/item/toy/tennis/blue,
/turf/open/floor/plasteel,
/area/ruin/powered/truckstop)
"fy" = (
/obj/machinery/door/airlock/freezer,
/obj/machinery/atmospherics/pipe/simple/supply/hidden/layer3{
	dir = 4
	},
/obj/machinery/atmospherics/pipe/simple/scrubbers/hidden/layer1{
	dir = 4
	},
/turf/open/floor/plasteel/showroomfloor,
/area/ruin/powered/truckstop)
"fD" = (
/obj/machinery/door/window/northleft{
	name = "Cooler Door"
	},
/obj/structure/rack,
/obj/item/reagent_containers/food/drinks/bottle/wine{
	pixel_x = 8
	},
/obj/item/reagent_containers/food/drinks/bottle/wine,
/obj/item/reagent_containers/food/drinks/bottle/wine{
	pixel_x = -8
	},
/turf/open/floor/plating,
/area/ruin/powered/truckstop)
"gl" = (
/turf/open/floor/wood,
/area/ruin/powered/truckstop)
"gF" = (
/obj/structure/cable{
	icon_state = "1-4"
	},
/turf/open/floor/plasteel/grimy,
/area/ruin/powered/truckstop)
"in" = (
/obj/structure/sink{
	dir = 8;
	pixel_x = -12;
	pixel_y = 2
	},
/obj/structure/mirror{
	pixel_x = -28
	},
/obj/machinery/atmospherics/pipe/simple/supply/hidden/layer3{
	dir = 5
	},
/obj/machinery/atmospherics/pipe/simple/scrubbers/hidden/layer1{
	dir = 5
	},
/turf/open/floor/plasteel/white,
/area/ruin/powered/truckstop)
"iv" = (
/obj/machinery/atmospherics/pipe/simple/supply/hidden/layer3{
	dir = 4
	},
/obj/machinery/atmospherics/pipe/simple/scrubbers/hidden/layer1{
	dir = 4
	},
/obj/effect/decal/cleanable/generic,
/turf/open/floor/plasteel,
/area/ruin/powered/truckstop)
"jh" = (
/obj/structure/table/reinforced,
/obj/structure/window/reinforced{
	dir = 8
	},
/obj/structure/window/reinforced,
/obj/item/kitchen/knife/combat/survival,
/turf/open/floor/wood,
/area/ruin/powered/truckstop)
"jq" = (
/obj/structure/rack,
/obj/item/reagent_containers/food/drinks/bottle/tomatojuice{
	pixel_x = 5
	},
/obj/item/reagent_containers/food/drinks/bottle/tomatojuice,
/obj/item/reagent_containers/food/drinks/bottle/tomatojuice{
	pixel_x = -5
	},
/obj/machinery/atmospherics/pipe/simple/supply/hidden/layer3{
	dir = 4
	},
/obj/machinery/atmospherics/pipe/simple/scrubbers/hidden/layer1{
	dir = 4
	},
/turf/open/floor/plasteel/cafeteria,
/area/ruin/powered/truckstop)
"kn" = (
/obj/machinery/door/airlock{
	name = "Gas Station Bathroom"
	},
/obj/machinery/atmospherics/pipe/simple/supply/hidden/layer3,
/obj/machinery/atmospherics/pipe/simple/scrubbers/hidden/layer1,
/turf/open/floor/plasteel/white,
/area/ruin/powered/truckstop)
"kM" = (
/obj/structure/table/reinforced,
/obj/structure/window/reinforced,
/obj/item/reagent_containers/rag,
/turf/open/floor/wood,
/area/ruin/powered/truckstop)
"kO" = (
/turf/open/floor/plating,
/area/ruin/powered/truckstop)
"mk" = (
/obj/structure/cable{
	icon_state = "1-2"
	},
/obj/machinery/light/small{
	dir = 4
	},
/turf/open/floor/plasteel/grimy,
/area/ruin/powered/truckstop)
"mE" = (
/obj/effect/turf_decal/tile/bar,
/obj/effect/turf_decal/tile/bar{
	dir = 1
	},
/obj/structure/table,
/obj/item/reagent_containers/food/condiment/saltshaker,
/turf/open/floor/plasteel,
/area/ruin/powered/truckstop)
"mR" = (
/obj/machinery/atmospherics/pipe/layer_manifold{
	dir = 4
	},
/turf/closed/wall,
/area/ruin/powered/truckstop)
"mV" = (
/obj/machinery/atmospherics/components/unary/portables_connector/visible{
	dir = 8
	},
/obj/machinery/portable_atmospherics/canister/air,
/turf/open/floor/plating,
/area/ruin/powered/truckstop)
"nM" = (
/obj/machinery/door/window/northleft{
	name = "Cooler Door"
	},
/obj/structure/rack,
/obj/item/reagent_containers/food/condiment/milk{
	pixel_x = -4
	},
/obj/item/reagent_containers/food/condiment/milk{
	pixel_x = 1
	},
/obj/item/reagent_containers/food/condiment/milk{
	pixel_x = 6
	},
/turf/open/floor/plating,
/area/ruin/powered/truckstop)
"or" = (
/obj/effect/decal/cleanable/vomit/old,
/turf/open/floor/plasteel,
/area/ruin/powered/truckstop)
"oL" = (
/turf/open/floor/plating/asteroid/snow/icemoon,
/area/ruin/powered/truckstop)
"oS" = (
/obj/structure/rack,
/obj/item/reagent_containers/food/condiment/mayonnaise,
/turf/open/floor/plasteel,
/area/ruin/powered/truckstop)
"pf" = (
/obj/effect/decal/cleanable/flour,
/turf/open/floor/plasteel,
/area/ruin/powered/truckstop)
"pv" = (
/obj/machinery/atmospherics/pipe/simple/supply/hidden/layer3{
	dir = 4
	},
/obj/structure/curtain,
/turf/open/floor/plasteel/grimy,
/area/ruin/powered/truckstop)
"py" = (
/obj/structure/cable{
	icon_state = "0-2"
	},
/obj/machinery/power/apc/auto_name/north,
/turf/open/floor/plasteel/grimy,
/area/ruin/powered/truckstop)
"pN" = (
/obj/structure/rack,
/obj/item/storage/box/donkpockets,
/obj/item/storage/box/donkpockets{
	pixel_x = 6;
	pixel_y = 5
	},
/turf/open/floor/plasteel/cafeteria,
/area/ruin/powered/truckstop)
"qN" = (
/obj/machinery/atmospherics/components/unary/vent_scrubber/on/layer1{
	dir = 4
	},
/turf/open/floor/plasteel/showroomfloor,
/area/ruin/powered/truckstop)
"qO" = (
/obj/machinery/light{
	dir = 8
	},
/turf/open/floor/plasteel/yellowsiding{
	dir = 4
	},
/area/ruin/powered/truckstop)
"rc" = (
/turf/open/floor/plasteel/yellowsiding/corner{
	dir = 4
	},
/area/ruin/powered/truckstop)
"rn" = (
/obj/machinery/atmospherics/components/unary/tank/air{
	dir = 8
	},
/obj/effect/decal/cleanable/cobweb{
	icon_state = "cobweb2"
	},
/turf/open/floor/plating,
/area/ruin/powered/truckstop)
"rs" = (
/mob/living/simple_animal/opossum{
	dir = 8
	},
/turf/open/floor/plasteel/white,
/area/ruin/powered/truckstop)
"rH" = (
/obj/effect/turf_decal/tile/bar,
/obj/effect/turf_decal/tile/bar{
	dir = 1
	},
/turf/open/floor/plasteel,
/area/ruin/powered/truckstop)
"rR" = (
/obj/structure/rack,
/obj/item/reagent_containers/food/snacks/branrequests{
	pixel_x = 4;
	pixel_y = 11
	},
/obj/item/reagent_containers/food/snacks/branrequests{
	pixel_x = 6;
	pixel_y = 7
	},
/obj/item/reagent_containers/food/snacks/branrequests{
	pixel_x = -5;
	pixel_y = 5
	},
/obj/item/reagent_containers/food/snacks/branrequests{
	pixel_x = 6;
	pixel_y = 7
	},
/turf/open/floor/plasteel/cafeteria,
/area/ruin/powered/truckstop)
"rU" = (
/obj/structure/rack,
/obj/item/reagent_containers/spray/pestspray{
	pixel_x = 20
	},
/obj/item/reagent_containers/spray/pestspray{
	pixel_x = 15
	},
/obj/item/reagent_containers/spray/pestspray{
	pixel_x = 10
	},
/obj/item/reagent_containers/spray/pestspray{
	pixel_x = 5
	},
/obj/item/reagent_containers/spray/pestspray,
/turf/open/floor/plasteel/cafeteria,
/area/ruin/powered/truckstop)
"sm" = (
/obj/structure/rack,
/obj/item/storage/fancy/cracker_pack{
	pixel_x = -5;
	pixel_y = 3
	},
/obj/item/storage/fancy/cracker_pack{
	pixel_y = -5
	},
/obj/item/storage/fancy/cracker_pack{
	pixel_x = 7
	},
/turf/open/floor/plasteel/cafeteria,
/area/ruin/powered/truckstop)
"sK" = (
/obj/machinery/atm{
	pixel_y = -30
	},
/obj/machinery/light/broken,
/turf/open/floor/plasteel/yellowsiding{
	dir = 1
	},
/area/ruin/powered/truckstop)
"tb" = (
/obj/effect/decal/cleanable/generic,
/turf/open/floor/plasteel,
/area/ruin/powered/truckstop)
"tF" = (
/turf/open/floor/plasteel/showroomfloor,
/area/ruin/powered/truckstop)
"tJ" = (
/obj/effect/turf_decal/tile/bar,
/obj/effect/turf_decal/tile/bar{
	dir = 1
	},
/obj/machinery/atmospherics/pipe/simple/supply/hidden/layer3{
	dir = 4
	},
/turf/open/floor/plasteel,
/area/ruin/powered/truckstop)
"uJ" = (
/obj/effect/decal/cleanable/dirt,
/turf/open/floor/plasteel,
/area/ruin/powered/truckstop)
"wJ" = (
/obj/structure/table/reinforced,
/obj/item/storage/box/drinkingglasses,
/turf/open/floor/wood,
/area/ruin/powered/truckstop)
"wO" = (
/obj/machinery/atmospherics/pipe/simple/supply/hidden/layer3{
	dir = 10
	},
/obj/machinery/atmospherics/pipe/simple/scrubbers/hidden/layer1{
	dir = 10
	},
/turf/open/floor/plasteel,
/area/ruin/powered/truckstop)
"wX" = (
/obj/machinery/atmospherics/pipe/simple/supply/hidden/layer3,
/obj/machinery/atmospherics/pipe/simple/scrubbers/hidden/layer1,
/turf/open/floor/plasteel,
/area/ruin/powered/truckstop)
"xc" = (
/obj/effect/decal/remains/human,
/obj/machinery/light/small/broken,
/turf/open/floor/plasteel,
/area/ruin/powered/truckstop)
"yt" = (
/turf/open/floor/plating/snowed/smoothed/icemoon,
/area/icemoon/surface/outdoors)
"yB" = (
/obj/machinery/light,
/turf/open/floor/plasteel/yellowsiding{
	dir = 9
	},
/area/ruin/powered/truckstop)
"zb" = (
/obj/structure/table/reinforced,
/obj/item/storage/fancy/cigarettes/cigars,
/obj/item/storage/fancy/cigarettes/cigars{
	pixel_x = 2;
	pixel_y = 2
	},
/obj/item/storage/fancy/cigarettes/cigars{
	pixel_x = 4;
	pixel_y = 4
	},
/obj/machinery/light{
	dir = 4
	},
/turf/open/floor/wood,
/area/ruin/powered/truckstop)
"zc" = (
/obj/machinery/light/small{
	dir = 1
	},
/turf/open/floor/plasteel,
/area/ruin/powered/truckstop)
"zZ" = (
/obj/machinery/power/smes,
/obj/structure/cable{
	icon_state = "0-8"
	},
/turf/open/floor/plating,
/area/ruin/powered/truckstop)
"AR" = (
/obj/machinery/atmospherics/pipe/simple/supply/hidden/layer3{
	dir = 4
	},
/obj/machinery/atmospherics/pipe/manifold/scrubbers/hidden/layer1{
	dir = 1
	},
/turf/open/floor/plasteel,
/area/ruin/powered/truckstop)
"AU" = (
/obj/machinery/atmospherics/pipe/simple/supply/hidden/layer3,
/obj/machinery/atmospherics/pipe/manifold/scrubbers/hidden/layer1{
	dir = 4
	},
/turf/open/floor/plasteel/showroomfloor,
/area/ruin/powered/truckstop)
"Ba" = (
/obj/machinery/atmospherics/pipe/simple/supply/hidden/layer3{
	dir = 10
	},
/obj/machinery/atmospherics/components/unary/vent_scrubber/on/layer1{
	dir = 8
	},
/turf/open/floor/plasteel/white,
/area/ruin/powered/truckstop)
"Bb" = (
/obj/effect/spawner/structure/window/reinforced,
/turf/open/floor/plating,
/area/ruin/powered/truckstop)
"Bu" = (
/obj/machinery/atmospherics/components/unary/vent_pump/on/layer3,
/turf/open/floor/plasteel/cafeteria,
/area/ruin/powered/truckstop)
"Di" = (
/obj/structure/table/reinforced,
/obj/structure/window/reinforced{
	dir = 8
	},
/obj/item/storage/fancy/donut_box{
	pixel_y = 10
	},
/obj/item/storage/fancy/donut_box{
	pixel_y = 2
	},
/turf/open/floor/wood,
/area/ruin/powered/truckstop)
"Dm" = (
/obj/structure/flora/grass/green,
/turf/open/floor/plating/asteroid/snow/icemoon,
/area/icemoon/surface/outdoors)
"DA" = (
/obj/machinery/door/window/northleft{
	name = "Cooler Door"
	},
/obj/structure/rack,
/obj/item/reagent_containers/food/drinks/soda_cans/maint_energy/megaflavor{
	pixel_x = -9;
	pixel_y = 6
	},
/obj/item/reagent_containers/food/drinks/soda_cans/maint_energy/megaflavor{
	pixel_x = -9
	},
/obj/item/reagent_containers/food/drinks/soda_cans/maint_energy/megaflavor{
	pixel_x = -9;
	pixel_y = -6
	},
/obj/item/reagent_containers/food/drinks/soda_cans/maint_energy/zero_fusion{
	pixel_y = 6
	},
/obj/item/reagent_containers/food/drinks/soda_cans/maint_energy/zero_fusion,
/obj/item/reagent_containers/food/drinks/soda_cans/maint_energy/zero_fusion{
	pixel_y = -6
	},
/obj/item/reagent_containers/food/drinks/soda_cans/maint_energy{
	pixel_x = 9;
	pixel_y = 6
	},
/obj/item/reagent_containers/food/drinks/soda_cans/maint_energy{
	pixel_x = 9
	},
/obj/item/reagent_containers/food/drinks/soda_cans/maint_energy{
	pixel_x = 9;
	pixel_y = -6
	},
/obj/machinery/atmospherics/pipe/simple/supply/hidden/layer3,
/obj/machinery/atmospherics/pipe/simple/scrubbers/hidden/layer1,
/turf/open/floor/plating,
/area/ruin/powered/truckstop)
"DH" = (
/obj/structure/rack,
/obj/item/toy/plush/lizardplushie{
	pixel_x = -8
	},
/obj/item/toy/plush/lizardplushie,
/obj/item/toy/plush/lizardplushie{
	pixel_x = 8
	},
/turf/open/floor/plasteel/cafeteria,
/area/ruin/powered/truckstop)
"DJ" = (
/obj/structure/sink{
	dir = 8;
	pixel_x = -12;
	pixel_y = 2
	},
/obj/structure/mirror{
	pixel_x = -28
	},
/obj/effect/decal/cleanable/ash,
/turf/open/floor/plasteel/white,
/area/ruin/powered/truckstop)
"DW" = (
/obj/effect/turf_decal/tile/bar,
/obj/effect/turf_decal/tile/bar{
	dir = 1
	},
/obj/structure/chair{
	dir = 8
	},
/turf/open/floor/plasteel,
/area/ruin/powered/truckstop)
"En" = (
/obj/structure/rack,
/obj/item/reagent_containers/food/snacks/cannedpeaches{
	pixel_x = 5
	},
/obj/item/reagent_containers/food/snacks/cannedpeaches{
	pixel_x = -5;
	pixel_y = 5
	},
/obj/item/reagent_containers/food/snacks/cannedpeaches,
/turf/open/floor/plasteel/cafeteria,
/area/ruin/powered/truckstop)
"ET" = (
/obj/machinery/atmospherics/pipe/simple/supply/hidden/layer3{
	dir = 5
	},
/obj/machinery/atmospherics/pipe/simple/scrubbers/hidden/layer1{
	dir = 6
	},
/turf/open/floor/plasteel/cafeteria,
/area/ruin/powered/truckstop)
"EY" = (
/obj/structure/table/wood,
/obj/machinery/chem_dispenser/drinks{
	dir = 8
	},
/obj/effect/turf_decal/tile/bar,
/obj/effect/turf_decal/tile/bar{
	dir = 1
	},
/turf/open/floor/plasteel,
/area/ruin/powered/truckstop)
"EZ" = (
/obj/machinery/atmospherics/pipe/simple/supply/hidden{
	dir = 6
	},
/obj/machinery/meter,
/turf/open/floor/plating,
/area/ruin/powered/truckstop)
"Fp" = (
/turf/open/floor/wood{
	icon_state = "wood-broken5"
	},
/area/ruin/powered/truckstop)
"FB" = (
/mob/living/simple_animal/cockroach,
/turf/open/floor/plasteel/showroomfloor,
/area/ruin/powered/truckstop)
"FN" = (
/obj/machinery/atmospherics/pipe/simple/scrubbers/hidden/layer1{
	dir = 9
	},
/obj/structure/rack,
/obj/item/reagent_containers/food/drinks/bottle/absinthe{
	pixel_x = -8
	},
/obj/item/reagent_containers/food/drinks/bottle/absinthe,
/obj/item/reagent_containers/food/drinks/bottle/absinthe{
	pixel_x = 8
	},
/turf/open/floor/plasteel,
/area/ruin/powered/truckstop)
"Gu" = (
/turf/open/floor/plasteel/cafeteria,
/area/ruin/powered/truckstop)
"GX" = (
/obj/machinery/door/window/northleft{
	name = "Cooler Door"
	},
/obj/structure/rack,
/obj/item/reagent_containers/food/drinks/bottle/sake{
	pixel_x = 7
	},
/obj/item/reagent_containers/food/drinks/bottle/sake,
/obj/item/reagent_containers/food/drinks/bottle/sake{
	pixel_x = -6
	},
/turf/open/floor/plating,
/area/ruin/powered/truckstop)
"HZ" = (
/obj/structure/cable{
	icon_state = "4-8"
	},
/obj/effect/decal/cleanable/oil,
/turf/open/floor/plating,
/area/ruin/powered/truckstop)
"Ia" = (
/obj/structure/rack,
/obj/item/reagent_containers/food/condiment/rice{
	list_reagents = list(/datum/reagent/consumable/rice = 90);
	name = "large rice sack";
	pixel_x = -10;
	possible_transfer_amounts = list(1,5,10,15,20,25,30,50,60,90)
	},
/obj/item/reagent_containers/food/condiment/rice{
	list_reagents = list(/datum/reagent/consumable/rice = 90);
	name = "large rice sack";
	pixel_x = -6;
	possible_transfer_amounts = list(1,5,10,15,20,25,30,50,60,90)
	},
/obj/item/reagent_containers/food/condiment/rice{
	list_reagents = list(/datum/reagent/consumable/rice = 90);
	name = "large rice sack";
	possible_transfer_amounts = list(1,5,10,15,20,25,30,50,60,90)
	},
/turf/open/floor/plasteel,
/area/ruin/powered/truckstop)
"IB" = (
/obj/structure/table/reinforced,
/obj/item/storage/fancy/cigarettes/cigpack_robustgold{
	pixel_x = 1;
	pixel_y = 4
	},
/obj/item/storage/fancy/cigarettes/cigpack_robustgold{
	pixel_x = -1;
	pixel_y = 2
	},
/obj/item/storage/fancy/cigarettes/cigpack_robustgold{
	pixel_x = -3
	},
/obj/item/storage/fancy/cigarettes/cigpack_robustgold{
	pixel_x = -5;
	pixel_y = -2
	},
/obj/item/storage/fancy/cigarettes/cigpack_uplift{
	pixel_x = 9;
	pixel_y = 4
	},
/obj/item/storage/fancy/cigarettes/cigpack_uplift{
	pixel_x = 7;
	pixel_y = 2
	},
/obj/item/storage/fancy/cigarettes/cigpack_uplift{
	pixel_x = 5
	},
/obj/item/storage/fancy/cigarettes/cigpack_uplift{
	pixel_x = 3;
	pixel_y = -2
	},
/turf/open/floor/wood,
/area/ruin/powered/truckstop)
"IE" = (
/obj/structure/reagent_dispensers/beerkeg,
/turf/open/floor/plasteel/showroomfloor,
/area/ruin/powered/truckstop)
"IO" = (
/obj/structure/flora/grass/brown,
/turf/open/floor/plating/asteroid/snow/icemoon,
/area/icemoon/surface/outdoors)
"IW" = (
/turf/open/floor/plating{
	icon_state = "platingdmg2"
	},
/area/ruin/powered/truckstop)
"KI" = (
/obj/structure/rack,
/obj/item/mop,
/obj/item/broom,
/obj/item/reagent_containers/spray/cleaner{
	pixel_x = -11
	},
/obj/item/reagent_containers/glass/bucket,
/turf/open/floor/plating,
/area/ruin/powered/truckstop)
"KL" = (
/turf/open/floor/plasteel/yellowsiding{
	dir = 5
	},
/area/ruin/powered/truckstop)
"Lp" = (
/obj/structure/rack,
/obj/item/storage/firstaid/regular{
	pixel_x = -5;
	pixel_y = 5
	},
/obj/item/storage/firstaid/regular,
/turf/open/floor/plasteel/cafeteria,
/area/ruin/powered/truckstop)
"Lv" = (
/obj/machinery/door/airlock{
	name = "Bathroom Stall"
	},
/turf/open/floor/plasteel/white,
/area/ruin/powered/truckstop)
"LF" = (
/obj/structure/rack,
/obj/item/reagent_containers/food/drinks/dry_ramen,
/obj/item/reagent_containers/food/drinks/dry_ramen{
	pixel_x = 10
	},
/obj/item/reagent_containers/food/drinks/dry_ramen{
	pixel_x = -4
	},
/obj/effect/decal/cleanable/cobweb,
/turf/open/floor/plasteel,
/area/ruin/powered/truckstop)
"LQ" = (
/obj/structure/table/reinforced,
/obj/structure/window/reinforced{
	dir = 8
	},
/obj/item/reagent_containers/food/drinks/britcup{
	pixel_x = -4;
	pixel_y = 8
	},
/obj/item/reagent_containers/food/drinks/britcup{
	pixel_x = -4;
	pixel_y = 1
	},
/obj/item/reagent_containers/food/drinks/britcup{
	pixel_x = -4;
	pixel_y = -6
	},
/turf/open/floor/wood,
/area/ruin/powered/truckstop)
"Mg" = (
/obj/effect/turf_decal/tile/bar,
/obj/effect/turf_decal/tile/bar{
	dir = 1
	},
/obj/structure/chair{
	dir = 4
	},
/turf/open/floor/plasteel,
/area/ruin/powered/truckstop)
"MD" = (
/obj/effect/turf_decal/tile/bar,
/obj/effect/turf_decal/tile/bar{
	dir = 1
	},
/obj/effect/decal/cleanable/glass,
/turf/open/floor/plasteel,
/area/ruin/powered/truckstop)
"MY" = (
/turf/open/floor/plasteel,
/area/ruin/powered/truckstop)
"Nm" = (
/obj/machinery/light/small{
	dir = 4
	},
/turf/open/floor/plasteel/grimy,
/area/ruin/powered/truckstop)
"Nw" = (
/obj/machinery/door/window/northleft{
	name = "Cooler Door"
	},
/obj/structure/rack,
/obj/item/reagent_containers/food/drinks/bottle/vodka/badminka{
	pixel_x = 5
	},
/obj/item/reagent_containers/food/drinks/bottle/vodka/badminka,
/obj/item/reagent_containers/food/drinks/bottle/vodka/badminka{
	pixel_x = -6
	},
/turf/open/floor/plating,
/area/ruin/powered/truckstop)
"ND" = (
/turf/open/floor/plating/asteroid/snow/icemoon,
/area/icemoon/surface/outdoors)
"Od" = (
/obj/structure/rack,
/obj/item/reagent_containers/glass/beaker/waterbottle/large{
	pixel_x = 6
	},
/obj/item/reagent_containers/glass/beaker/waterbottle/large,
/obj/item/reagent_containers/glass/beaker/waterbottle/large{
	pixel_x = -6
	},
/turf/open/floor/plasteel/cafeteria,
/area/ruin/powered/truckstop)
"OB" = (
/obj/structure/cable{
	icon_state = "1-2"
	},
/obj/machinery/atmospherics/pipe/layer_manifold{
	dir = 4
	},
/turf/open/floor/plasteel/grimy,
/area/ruin/powered/truckstop)
"OJ" = (
/obj/machinery/atmospherics/pipe/manifold/supply/hidden/layer3,
/obj/machinery/atmospherics/pipe/simple/scrubbers/hidden/layer1{
	dir = 5
	},
/turf/open/floor/plasteel/showroomfloor,
/area/ruin/powered/truckstop)
"PN" = (
/obj/structure/table/reinforced,
/turf/open/floor/wood,
/area/ruin/powered/truckstop)
"Qj" = (
/obj/structure/reagent_dispensers/fueltank,
/turf/open/floor/plating/snowed/smoothed/icemoon,
/area/icemoon/surface/outdoors)
"Qn" = (
/mob/living/simple_animal/cockroach,
/turf/open/floor/plasteel,
/area/ruin/powered/truckstop)
"Rk" = (
/turf/open/floor/wood{
	icon_state = "wood-broken"
	},
/area/ruin/powered/truckstop)
"RX" = (
/obj/effect/turf_decal/tile/bar,
/obj/effect/turf_decal/tile/bar{
	dir = 1
	},
/obj/machinery/atmospherics/pipe/simple/supply/hidden/layer3{
	dir = 4
	},
/obj/effect/decal/cleanable/dirt,
/turf/open/floor/plasteel,
/area/ruin/powered/truckstop)
"SW" = (
/obj/machinery/atmospherics/components/unary/vent_scrubber/on/layer1{
	dir = 1
	},
/turf/open/floor/plasteel/cafeteria,
/area/ruin/powered/truckstop)
"Td" = (
/obj/machinery/atmospherics/pipe/manifold/supply/hidden,
/turf/open/floor/plating{
	icon_state = "platingdmg3"
	},
/area/ruin/powered/truckstop)
"TL" = (
/turf/closed/wall,
/area/ruin/powered/truckstop)
"Ua" = (
/obj/structure/table/reinforced,
/obj/machinery/door/window/northleft{
	name = "Attendant Window"
	},
/turf/open/floor/wood,
/area/ruin/powered/truckstop)
"Ud" = (
/turf/template_noop,
/area/template_noop)
"Uf" = (
/obj/machinery/atmospherics/pipe/simple/scrubbers/hidden{
	dir = 4
	},
/turf/open/floor/plating/asteroid/snow/icemoon,
/area/ruin/powered/truckstop)
"Up" = (
/obj/machinery/atmospherics/components/unary/outlet_injector/on{
	dir = 4
	},
/turf/open/floor/plating/asteroid/snow/icemoon,
/area/ruin/powered/truckstop)
"Ur" = (
/obj/effect/decal/cleanable/greenglow,
/turf/open/floor/plasteel/white,
/area/ruin/powered/truckstop)
"Ux" = (
/obj/machinery/light/small,
/obj/machinery/atmospherics/components/unary/vent_pump/on/layer3{
	dir = 1
	},
/turf/open/floor/plasteel/white,
/area/ruin/powered/truckstop)
"Vb" = (
/obj/machinery/atmospherics/pipe/simple/supply/hidden/layer3{
	dir = 4
	},
/obj/effect/decal/cleanable/ash,
/turf/open/floor/plasteel,
/area/ruin/powered/truckstop)
"Vx" = (
/obj/structure/rack,
/obj/item/reagent_containers/food/drinks/dry_ramen{
	pixel_x = 4
	},
/obj/item/reagent_containers/food/drinks/dry_ramen{
	pixel_x = 10
	},
/obj/item/reagent_containers/food/drinks/dry_ramen{
	pixel_x = -4
	},
/obj/item/reagent_containers/food/drinks/dry_ramen,
/turf/open/floor/plasteel/cafeteria,
/area/ruin/powered/truckstop)
"VE" = (
/obj/structure/table/wood,
/obj/effect/turf_decal/tile/bar,
/obj/effect/turf_decal/tile/bar{
	dir = 1
	},
/obj/machinery/microwave{
	pixel_y = 6
	},
/obj/machinery/light{
	dir = 4
	},
/turf/open/floor/plasteel,
/area/ruin/powered/truckstop)
"Ww" = (
/obj/machinery/atmospherics/pipe/simple/supply/hidden/layer3{
	dir = 6
	},
/obj/machinery/atmospherics/pipe/simple/scrubbers/hidden/layer1{
	dir = 6
	},
/obj/effect/decal/cleanable/insectguts,
/turf/open/floor/plasteel,
/area/ruin/powered/truckstop)
"Wy" = (
/obj/structure/toilet,
/obj/item/screwdriver,
/obj/effect/decal/cleanable/blood/old,
/turf/open/floor/plasteel/white,
/area/ruin/powered/truckstop)
"Xs" = (
/obj/effect/decal/remains/robot,
/turf/open/floor/plating/snowed/smoothed/icemoon,
/area/icemoon/surface/outdoors)
"Xw" = (
/obj/machinery/door/airlock/public/glass{
	name = "Gas Station"
	},
/obj/structure/fans/tiny,
/turf/open/floor/plasteel,
/area/ruin/powered/truckstop)
"XA" = (
/obj/structure/cable{
	icon_state = "1-2"
	},
/turf/open/floor/plasteel/grimy,
/area/ruin/powered/truckstop)
"XZ" = (
/obj/machinery/atmospherics/components/unary/vent_pump/on/layer3{
	dir = 4
	},
/turf/open/floor/plasteel/showroomfloor,
/area/ruin/powered/truckstop)
"Ye" = (
/obj/machinery/computer/arcade/tetris{
	dir = 1
	},
/turf/open/floor/plasteel,
/area/ruin/powered/truckstop)
"YT" = (
/turf/open/floor/plasteel/yellowsiding{
	dir = 1
	},
/area/ruin/powered/truckstop)
"ZE" = (
/obj/machinery/door/airlock{
	name = "Checkout Counter"
	},
/turf/open/floor/wood,
/area/ruin/powered/truckstop)
"ZN" = (
/obj/structure/reagent_dispensers/watertank/high,
/turf/open/floor/plating,
/area/ruin/powered/truckstop)
"ZZ" = (
/obj/effect/decal/cleanable/cobweb,
/turf/open/floor/plasteel,
/area/ruin/powered/truckstop)

(1,1,1) = {"
Ud
Ud
Ud
ay
ay
ay
ay
ay
ay
ay
ay
ay
ay
ay
ay
ay
ay
ay
ay
ay
Ud
Ud
Ud
Ud
Ud
"}
(2,1,1) = {"
Ud
Ud
Ud
ay
ND
Dm
ND
ND
ND
ay
ay
ay
ay
ay
ay
ay
ay
ay
ND
ND
ND
ND
Ud
Ud
Ud
"}
(3,1,1) = {"
Ud
Ud
ND
ND
ND
ND
ND
yB
TL
TL
TL
TL
TL
TL
TL
TL
TL
TL
TL
TL
TL
ND
ND
Ud
Ud
"}
(4,1,1) = {"
Ud
Ud
ND
ND
yt
yt
yt
YT
Bb
ZZ
eo
MY
MY
Qn
eo
MY
MY
fD
az
IE
TL
Dm
ND
Ud
Ud
"}
(5,1,1) = {"
Ud
Ud
ND
ND
yt
yt
Xs
YT
Bb
MY
rR
En
ds
Lp
Od
DH
MY
Nw
tF
IE
TL
ND
ND
IO
Ud
"}
(6,1,1) = {"
Ud
Ud
ND
ND
yt
yt
yt
YT
Bb
MY
Gu
aw
Bu
ET
SW
Gu
MY
GX
tF
FB
TL
IO
ND
ND
Ud
"}
(7,1,1) = {"
Ud
Ud
ND
ND
yt
Qj
yt
YT
Xw
or
pN
Vx
sm
jq
dB
rU
MY
nM
qN
XZ
TL
Up
ND
Dm
Ud
"}
(8,1,1) = {"
Ud
ND
ND
IO
yt
yt
yt
YT
Bb
MY
MY
MY
tb
wO
wX
ec
wX
DA
AU
OJ
TL
Uf
ND
ND
ay
"}
(9,1,1) = {"
Ud
ND
ND
ND
yt
yt
yt
YT
Xw
uJ
uJ
MY
MY
MY
MY
Vb
Ye
TL
TL
fy
TL
mR
TL
ND
ay
"}
(10,1,1) = {"
Ud
ND
ND
ND
ND
IO
ND
YT
TL
Di
PN
LQ
jh
rH
aE
tJ
Mg
TL
LF
AR
fr
FN
TL
ND
ay
"}
(11,1,1) = {"
Ud
ND
ND
ND
yt
yt
yt
YT
Ua
eh
gl
Fp
wJ
MD
rH
tJ
mE
TL
zc
iv
pf
xc
TL
ay
ay
"}
(12,1,1) = {"
Ud
ay
Dm
ND
yt
yt
yt
YT
TL
IB
zb
Rk
kM
EY
VE
RX
DW
TL
Ww
aW
oS
Ia
TL
ay
Ud
"}
(13,1,1) = {"
Ud
ay
ND
ND
yt
Qj
yt
sK
TL
TL
TL
ZE
TL
TL
TL
pv
TL
TL
fi
TL
TL
TL
TL
ay
Ud
"}
(14,1,1) = {"
ay
ay
ay
ND
yt
yt
yt
KL
qO
rc
TL
py
XA
mk
XA
OB
gF
Nm
dx
kn
in
DJ
TL
ay
ay
"}
(15,1,1) = {"
ay
ay
ay
ND
yt
yt
yt
oL
oL
YT
TL
IW
kO
TL
EZ
Td
HZ
TL
TL
TL
Ba
Ux
TL
ay
ay
"}
(16,1,1) = {"
ay
ay
ay
ND
yt
yt
yt
oL
oL
YT
TL
ZN
KI
TL
rn
mV
zZ
TL
Wy
Lv
rs
Ur
TL
ay
ay
"}
(17,1,1) = {"
Ud
ay
ay
ND
ND
ND
ND
oL
oL
KL
TL
TL
TL
TL
TL
TL
TL
TL
TL
TL
TL
TL
TL
ay
ay
"}
(18,1,1) = {"
Ud
Ud
ay
ay
IO
ND
ND
ND
Dm
ND
ND
ND
ay
ay
ay
ay
ay
ay
ay
ay
ay
ay
ay
ay
Ud
"}
(19,1,1) = {"
Ud
Ud
Ud
Ud
Ud
Ud
Ud
ND
ND
ND
ND
ay
ay
ay
ay
ay
ay
ay
ay
ay
ay
ay
ay
Ud
Ud
"}
(20,1,1) = {"
Ud
Ud
Ud
Ud
Ud
Ud
Ud
Ud
Ud
Ud
ay
ay
ay
ay
ay
ay
ay
ay
Ud
Ud
Ud
Ud
Ud
Ud
Ud
"}
