//MAP CONVERTED BY dmm2tgm.py THIS HEADER COMMENT PREVENTS RECONVERSION, DO NOT REMOVE
"a" = (
/turf/template_noop,
/area/template_noop)
"b" = (
/obj/item/flashlight/lantern{
	on = 1
	},
/obj/machinery/light/floor/fakeday,
/turf/open/floor/plating/asteroid/snow/icemoon,
/area/icemoon/surface/outdoors)
"c" = (
/obj/item/flashlight/lantern,
/obj/machinery/light/floor/fakeday,
/turf/open/floor/plating/asteroid/snow/icemoon,
/area/icemoon/surface/outdoors)
"d" = (
/obj/structure/table/wood,
/obj/item/book/manual/hydroponics_pod_people,
/turf/open/floor/wood,
/area/icemoon/surface/outdoors)
"e" = (
/obj/machinery/hydroponics/soil,
/obj/machinery/light/floor/fakeday,
/turf/open/floor/plating/asteroid/snow/icemoon,
/area/icemoon/surface/outdoors)
"f" = (
/obj/structure/punching_bag,
/turf/open/floor/wood,
/area/icemoon/surface/outdoors)
"g" = (
/obj/structure/fluff{
	name = "dope ass desk"
	},
/obj/structure/mirror{
	pixel_y = 32
	},
/turf/open/floor/wood,
/area/icemoon/surface/outdoors)
"h" = (
/obj/structure/closet/emcloset/anchored,
/turf/open/floor/wood,
/area/icemoon/surface/outdoors)
"i" = (
/obj/structure/flora/tree/pine,
/turf/open/floor/plating/asteroid/snow/icemoon,
/area/icemoon/surface/outdoors)
"j" = (
/obj/item/clothing/suit/jacket/letterman_nanotrasen,
/obj/structure/closet/crate/wooden,
/turf/open/floor/plating,
/area/icemoon/surface/outdoors)
"k" = (
/obj/structure/flora/rock/pile/icy,
/obj/machinery/light/floor/fakeday,
/turf/open/floor/plating/asteroid/snow/icemoon,
/area/icemoon/surface/outdoors)
"l" = (
/obj/machinery/light/floor/fakeday,
/mob/living/simple_animal/pet/penguin/emperor{
	atmos_requirements = list("min_oxy" = 0, "max_oxy" = 0, "min_tox" = 0, "max_tox" = 0, "min_co2" = 0, "max_co2" = 0, "min_n2" = 0, "max_n2" = 0)
	},
/turf/open/floor/plating/asteroid/snow/icemoon,
/area/icemoon/surface/outdoors)
"m" = (
/turf/closed/mineral/random/snow/more_caves,
/area/icemoon/surface/outdoors)
"n" = (
/turf/open/floor/plating/asteroid/snow/icemoon,
/area/icemoon/surface/outdoors)
"p" = (
/obj/structure/falsewall/wood,
/turf/open/floor/plating,
/area/icemoon/surface/outdoors)
"q" = (
/obj/machinery/light/floor/fakeday,
/obj/structure/sink/well,
/turf/open/floor/plating/ice/smooth,
/area/icemoon/surface/outdoors)
"r" = (
/turf/closed/mineral/snowmountain,
/area/icemoon/surface/outdoors)
"t" = (
/obj/structure/ore_box,
/obj/machinery/light/floor/fakeday,
/turf/open/floor/plating/asteroid/snow/icemoon,
/area/icemoon/surface/outdoors)
"u" = (
/obj/structure/sign/poster/official/hydro_ad{
	pixel_y = 32
	},
/turf/open/floor/wood,
/area/icemoon/surface/outdoors)
"v" = (
/obj/machinery/light/floor/fakeday,
/mob/living/simple_animal/pet/penguin/emperor{
	atmos_requirements = list("min_oxy" = 0, "max_oxy" = 0, "min_tox" = 0, "max_tox" = 0, "min_co2" = 0, "max_co2" = 0, "min_n2" = 0, "max_n2" = 0)
	},
/turf/open/floor/plating/ice/smooth,
/area/icemoon/surface/outdoors)
"w" = (
/obj/structure/bed,
/obj/effect/landmark/loneopspawn,
/turf/open/floor/wood,
/area/icemoon/surface/outdoors)
"x" = (
/turf/open/floor/plating,
/area/icemoon/surface/outdoors)
"y" = (
/obj/structure/mineral_door/woodrustic,
/turf/open/floor/wood,
/area/icemoon/surface/outdoors)
"z" = (
/obj/item/hatchet,
/obj/machinery/light/floor/fakeday,
/turf/open/floor/plating/asteroid/snow/icemoon,
/area/icemoon/surface/outdoors)
"A" = (
/turf/open/floor/wood{
	icon_state = "wood-broken7"
	},
/area/icemoon/surface/outdoors)
"B" = (
/obj/structure/flora/grass/green,
/obj/machinery/light/floor/fakeday,
/turf/open/floor/plating/asteroid/snow/icemoon,
/area/icemoon/surface/outdoors)
"C" = (
/obj/structure/fluff/snowlegion,
/obj/machinery/light/floor/fakeday,
/turf/open/floor/plating/asteroid/snow/icemoon,
/area/icemoon/surface/outdoors)
"E" = (
/turf/open/floor/wood{
	icon_state = "wood-broken6"
	},
/area/icemoon/surface/outdoors)
"F" = (
/obj/structure/bonfire,
/obj/machinery/light/floor/fakeday,
/turf/open/floor/plating/asteroid/snow/icemoon,
/area/icemoon/surface/outdoors)
"G" = (
/turf/closed/wall/mineral/wood,
/area/icemoon/surface/outdoors)
"H" = (
/obj/structure/table/wood,
/obj/item/flashlight/lamp/green{
	pixel_x = 1;
	pixel_y = 5
	},
/turf/open/floor/wood,
/area/icemoon/surface/outdoors)
"I" = (
/turf/open/floor/wood,
/area/icemoon/surface/outdoors)
"K" = (
/obj/structure/table/wood,
/obj/item/hatchet,
/turf/open/floor/wood{
	icon_state = "wood-broken4"
	},
/area/icemoon/surface/outdoors)
"L" = (
/turf/open/floor/wood{
	icon_state = "wood-broken5"
	},
/area/icemoon/surface/outdoors)
"M" = (
/obj/structure/rack,
/obj/item/hatchet,
/obj/item/hatchet,
/turf/open/floor/wood,
/area/icemoon/surface/outdoors)
"O" = (
/obj/structure/beebox,
/obj/machinery/light/floor/fakeday,
/turf/open/floor/plating/asteroid/snow/icemoon,
/area/icemoon/surface/outdoors)
"P" = (
/obj/structure/mineral_door/woodrustic,
/turf/open/floor/wood{
	icon_state = "wood-broken7"
	},
/area/icemoon/surface/outdoors)
"Q" = (
/turf/open/floor/wood{
	icon_state = "wood-broken4"
	},
/area/icemoon/surface/outdoors)
"R" = (
/obj/machinery/light/floor/fakeday,
/turf/open/floor/plating/ice/smooth,
/area/icemoon/surface/outdoors)
"S" = (
/obj/structure/table/wood,
/obj/item/flashlight/lantern{
	on = 1
	},
/turf/open/floor/wood,
/area/icemoon/surface/outdoors)
"U" = (
/obj/structure/rack,
/obj/item/clothing/suit/hooded/wintercoat/hydro,
/obj/item/clothing/suit/hooded/wintercoat/hydro{
	pixel_x = 6;
	pixel_y = 6
	},
/turf/open/floor/wood,
/area/icemoon/surface/outdoors)
"V" = (
/obj/structure/fermenting_barrel,
/turf/open/floor/plating,
/area/icemoon/surface/outdoors)
"W" = (
/obj/effect/landmark/loneopspawn,
/obj/machinery/light/floor/fakeday,
/turf/open/floor/plating/asteroid/snow/icemoon,
/area/icemoon/surface/outdoors)
"Y" = (
/obj/machinery/light/floor/fakeday,
/turf/open/floor/plating/asteroid/snow/icemoon,
/area/icemoon/surface/outdoors)

(1,1,1) = {"
a
a
a
a
a
a
a
a
a
a
a
a
a
a
a
a
a
a
a
a
"}
(2,1,1) = {"
a
a
r
r
r
r
r
a
a
m
m
m
m
m
m
m
a
a
a
a
"}
(3,1,1) = {"
a
a
r
j
x
r
r
r
r
m
m
m
m
m
m
m
m
m
a
a
"}
(4,1,1) = {"
a
r
r
V
x
x
r
r
m
Y
Y
Y
i
Y
Y
m
m
m
a
a
"}
(5,1,1) = {"
a
r
G
G
p
G
G
B
Y
Y
c
Y
B
Y
B
Y
m
m
a
a
"}
(6,1,1) = {"
a
r
G
u
I
A
G
Y
Y
F
Y
Y
Y
W
Y
Y
Y
m
m
a
"}
(7,1,1) = {"
a
r
G
w
E
w
G
c
Y
Y
e
e
e
Y
Y
Y
B
m
m
a
"}
(8,1,1) = {"
a
r
G
g
I
U
G
Y
C
Y
Y
z
Y
Y
Y
i
Y
m
m
a
"}
(9,1,1) = {"
a
m
G
f
Q
M
G
Y
Y
Y
e
e
e
Y
Y
B
Y
m
m
a
"}
(10,1,1) = {"
a
m
G
H
I
h
G
B
Y
Y
Y
Y
Y
Y
O
Y
Y
Y
m
a
"}
(11,1,1) = {"
a
m
G
d
I
L
y
Y
Y
B
e
e
e
Y
Y
Y
Y
i
m
a
"}
(12,1,1) = {"
a
m
G
K
S
I
P
Y
Y
R
l
l
Y
Y
Y
Y
B
Y
m
a
"}
(13,1,1) = {"
a
m
G
G
G
G
G
Y
R
R
R
Y
Y
Y
Y
O
Y
b
m
a
"}
(14,1,1) = {"
a
m
m
n
i
t
Y
Y
q
v
R
Y
Y
O
Y
Y
Y
Y
m
m
"}
(15,1,1) = {"
a
m
m
m
Y
B
Y
Y
R
R
R
R
Y
Y
Y
Y
i
B
m
m
"}
(16,1,1) = {"
a
a
m
m
Y
i
Y
Y
R
R
R
R
Y
Y
W
Y
Y
Y
m
m
"}
(17,1,1) = {"
a
a
m
m
k
Y
Y
W
Y
R
R
Y
Y
B
Y
Y
O
Y
m
m
"}
(18,1,1) = {"
a
a
a
m
Y
Y
Y
Y
Y
Y
Y
Y
Y
Y
Y
i
Y
m
m
a
"}
(19,1,1) = {"
a
a
a
m
m
Y
Y
i
Y
Y
Y
i
Y
Y
Y
B
m
m
m
a
"}
(20,1,1) = {"
a
a
a
m
m
m
m
m
B
Y
Y
Y
k
Y
m
m
m
a
a
a
"}
(21,1,1) = {"
a
a
a
a
a
m
m
m
m
m
m
m
m
m
m
m
m
a
a
a
"}
(22,1,1) = {"
a
a
a
a
a
a
a
a
a
a
a
a
m
m
m
m
a
a
a
a
"}
