//MAP CONVERTED BY dmm2tgm.py THIS HEADER COMMENT PREVENTS RECONVERSION, DO NOT REMOVE
"ay" = (
/turf/closed/mineral/random/snow/more_caves,
/area/icemoon/underground/explored)
"az" = (
/obj/machinery/light/small{
	dir = 8
	},
/turf/open/floor/plasteel/showroomfloor,
/area/ruin/powered)
"aW" = (
/obj/machinery/atmospherics/pipe/simple/supply/hidden/layer3{
	dir = 9
	},
/obj/machinery/atmospherics/pipe/simple/scrubbers/hidden/layer1{
	dir = 9
	},
/obj/structure/rack,
/obj/item/toy/plush/lizardplushie{
	pixel_x = -8
	},
/obj/item/toy/plush/lizardplushie/piano,
/obj/item/toy/plush/lizardplushie{
	pixel_x = 8
	},
/turf/open/floor/plasteel,
/area/ruin/powered)
"ds" = (
/obj/structure/rack,
/obj/item/reagent_containers/food/snacks/customizable/bread,
/obj/item/reagent_containers/food/snacks/customizable/bread{
	pixel_x = 5;
	pixel_y = -4
	},
/turf/open/floor/plasteel,
/area/ruin/powered)
"dB" = (
/obj/structure/rack,
/obj/item/storage/pill_bottle/dice{
	pixel_x = 6
	},
/obj/item/storage/pill_bottle/dice,
/obj/item/storage/pill_bottle/dice{
	pixel_x = -6
	},
/turf/open/floor/plasteel,
/area/ruin/powered)
"ec" = (
/obj/machinery/atmospherics/pipe/manifold/supply/hidden/layer3{
	dir = 8
	},
/obj/machinery/atmospherics/pipe/simple/scrubbers/hidden/layer1,
/turf/open/floor/plasteel,
/area/ruin/powered)
"eo" = (
/obj/machinery/light{
	dir = 8
	},
/turf/open/floor/plasteel,
/area/ruin/powered)
"fi" = (
/obj/machinery/door/airlock{
	name = "Back Room"
	},
/obj/machinery/atmospherics/pipe/simple/supply/hidden/layer3{
	dir = 4
	},
/obj/machinery/atmospherics/pipe/simple/scrubbers/hidden/layer1{
	dir = 4
	},
/turf/open/floor/plasteel,
/area/ruin/powered)
"fr" = (
/obj/machinery/atmospherics/pipe/simple/scrubbers/hidden/layer1,
/obj/structure/rack,
/obj/item/toy/seashell,
/obj/item/toy/tennis/yellow,
/obj/item/toy/tennis/blue,
/turf/open/floor/plasteel,
/area/ruin/powered)
"fy" = (
/obj/machinery/door/airlock/freezer,
/obj/machinery/atmospherics/pipe/simple/supply/hidden/layer3{
	dir = 4
	},
/obj/machinery/atmospherics/pipe/simple/scrubbers/hidden/layer1{
	dir = 4
	},
/turf/open/floor/plasteel/showroomfloor,
/area/ruin/powered)
"fD" = (
/obj/machinery/door/window/northleft{
	name = "Cooler Door"
	},
/obj/structure/rack,
/obj/item/reagent_containers/food/drinks/bottle/wine{
	pixel_x = 8
	},
/obj/item/reagent_containers/food/drinks/bottle/wine,
/obj/item/reagent_containers/food/drinks/bottle/wine{
	pixel_x = -8
	},
/turf/open/floor/plating,
/area/ruin/powered)
"gF" = (
/obj/structure/cable{
	icon_state = "1-4"
	},
/turf/open/floor/plasteel,
/area/ruin/powered)
"in" = (
/obj/structure/sink{
	dir = 8;
	pixel_x = -12;
	pixel_y = 2
	},
/obj/structure/mirror{
	pixel_x = -28
	},
/obj/machinery/atmospherics/pipe/simple/supply/hidden/layer3{
	dir = 5
	},
/obj/machinery/atmospherics/pipe/simple/scrubbers/hidden/layer1{
	dir = 5
	},
/turf/open/floor/plasteel,
/area/ruin/powered)
"iv" = (
/obj/machinery/atmospherics/pipe/simple/supply/hidden/layer3{
	dir = 4
	},
/obj/machinery/atmospherics/pipe/simple/scrubbers/hidden/layer1{
	dir = 4
	},
/turf/open/floor/plasteel,
/area/ruin/powered)
"jh" = (
/obj/structure/table/reinforced,
/obj/structure/window/reinforced{
	dir = 8
	},
/obj/structure/window/reinforced,
/obj/item/kitchen/knife/combat/survival,
/turf/open/floor/plasteel,
/area/ruin/powered)
"jq" = (
/obj/structure/rack,
/obj/item/reagent_containers/food/drinks/bottle/tomatojuice{
	pixel_x = 5
	},
/obj/item/reagent_containers/food/drinks/bottle/tomatojuice,
/obj/item/reagent_containers/food/drinks/bottle/tomatojuice{
	pixel_x = -5
	},
/obj/machinery/atmospherics/pipe/simple/supply/hidden/layer3{
	dir = 4
	},
/obj/machinery/atmospherics/pipe/simple/scrubbers/hidden/layer1{
	dir = 4
	},
/turf/open/floor/plasteel,
/area/ruin/powered)
"kn" = (
/obj/machinery/door/airlock{
	name = "Gas Station Bathroom"
	},
/obj/machinery/atmospherics/pipe/simple/supply/hidden,
/obj/machinery/atmospherics/pipe/simple/scrubbers/hidden,
/obj/machinery/atmospherics/pipe/simple/supply/hidden/layer3,
/obj/machinery/atmospherics/pipe/simple/scrubbers/hidden/layer1,
/turf/open/floor/plasteel,
/area/ruin/powered)
"kM" = (
/obj/structure/table/reinforced,
/obj/structure/window/reinforced,
/obj/item/reagent_containers/rag,
/turf/open/floor/plasteel,
/area/ruin/powered)
"mk" = (
/obj/structure/cable{
	icon_state = "1-2"
	},
/obj/machinery/light{
	dir = 4
	},
/turf/open/floor/plasteel,
/area/ruin/powered)
"mE" = (
/obj/effect/turf_decal/tile/bar,
/obj/effect/turf_decal/tile/bar{
	dir = 1
	},
/obj/structure/table,
/obj/item/reagent_containers/food/condiment/saltshaker,
/turf/open/floor/plasteel,
/area/ruin/powered)
"mR" = (
/obj/machinery/atmospherics/pipe/layer_manifold{
	dir = 4
	},
/turf/closed/wall,
/area/ruin/powered)
"mV" = (
/obj/machinery/atmospherics/components/unary/portables_connector/visible{
	dir = 8
	},
/obj/machinery/portable_atmospherics/canister/air,
/turf/open/floor/plating,
/area/ruin/powered)
"nM" = (
/obj/machinery/door/window/northleft{
	name = "Cooler Door"
	},
/obj/structure/rack,
/obj/item/reagent_containers/food/condiment/milk{
	pixel_x = -4
	},
/obj/item/reagent_containers/food/condiment/milk{
	pixel_x = 1
	},
/obj/item/reagent_containers/food/condiment/milk{
	pixel_x = 6
	},
/turf/open/floor/plating,
/area/ruin/powered)
"oS" = (
/obj/structure/rack,
/obj/item/reagent_containers/food/condiment/mayonnaise,
/turf/open/floor/plasteel,
/area/ruin/powered)
"py" = (
/obj/structure/cable{
	icon_state = "0-2"
	},
/obj/machinery/power/apc/auto_name/north,
/turf/open/floor/plasteel,
/area/ruin/powered)
"pN" = (
/obj/structure/rack,
/obj/item/storage/box/donkpockets,
/obj/item/storage/box/donkpockets{
	pixel_x = 3;
	pixel_y = 3
	},
/obj/item/storage/box/donkpockets{
	pixel_x = 6;
	pixel_y = 5
	},
/turf/open/floor/plasteel,
/area/ruin/powered)
"qN" = (
/obj/machinery/atmospherics/components/unary/vent_scrubber/on/layer1{
	dir = 4
	},
/turf/open/floor/plasteel/showroomfloor,
/area/ruin/powered)
"qO" = (
/obj/machinery/light{
	dir = 8
	},
/turf/open/floor/plasteel/yellowsiding{
	dir = 4
	},
/area/icemoon/surface/outdoors)
"rc" = (
/turf/open/floor/plasteel/yellowsiding/corner{
	dir = 4
	},
/area/icemoon/surface/outdoors)
"rn" = (
/obj/machinery/atmospherics/components/unary/tank/air,
/turf/open/floor/plating,
/area/ruin/powered)
"rs" = (
/mob/living/simple_animal/opossum{
	dir = 8
	},
/turf/open/floor/plasteel,
/area/ruin/powered)
"rH" = (
/obj/effect/turf_decal/tile/bar,
/obj/effect/turf_decal/tile/bar{
	dir = 1
	},
/turf/open/floor/plasteel,
/area/ruin/powered)
"rR" = (
/obj/structure/rack,
/obj/item/reagent_containers/food/snacks/branrequests{
	pixel_x = 4;
	pixel_y = 11
	},
/obj/item/reagent_containers/food/snacks/branrequests{
	pixel_x = 6;
	pixel_y = 7
	},
/obj/item/reagent_containers/food/snacks/branrequests{
	pixel_x = -5;
	pixel_y = 5
	},
/obj/item/reagent_containers/food/snacks/branrequests{
	pixel_x = 6;
	pixel_y = 7
	},
/turf/open/floor/plasteel,
/area/ruin/powered)
"rU" = (
/obj/structure/rack,
/obj/item/reagent_containers/spray/pestspray{
	pixel_x = 20
	},
/obj/item/reagent_containers/spray/pestspray{
	pixel_x = 15
	},
/obj/item/reagent_containers/spray/pestspray{
	pixel_x = 10
	},
/obj/item/reagent_containers/spray/pestspray{
	pixel_x = 5
	},
/obj/item/reagent_containers/spray/pestspray,
/turf/open/floor/plasteel,
/area/ruin/powered)
"sm" = (
/obj/structure/rack,
/obj/item/storage/fancy/cracker_pack{
	pixel_y = -5
	},
/obj/item/storage/fancy/cracker_pack{
	pixel_x = 7
	},
/obj/item/storage/fancy/cracker_pack{
	pixel_x = -5;
	pixel_y = 3
	},
/turf/open/floor/plasteel,
/area/ruin/powered)
"sK" = (
/obj/machinery/atm{
	pixel_y = -30
	},
/obj/machinery/light,
/turf/open/floor/plasteel/yellowsiding{
	dir = 1
	},
/area/icemoon/surface/outdoors)
"tF" = (
/turf/open/floor/plasteel/showroomfloor,
/area/ruin/powered)
"tJ" = (
/obj/effect/turf_decal/tile/bar,
/obj/effect/turf_decal/tile/bar{
	dir = 1
	},
/obj/machinery/atmospherics/pipe/simple/supply/hidden/layer3{
	dir = 4
	},
/turf/open/floor/plasteel,
/area/ruin/powered)
"wJ" = (
/obj/structure/table/reinforced,
/obj/item/storage/box/drinkingglasses,
/turf/open/floor/plasteel,
/area/ruin/powered)
"wO" = (
/obj/machinery/atmospherics/pipe/simple/supply/hidden/layer3{
	dir = 10
	},
/obj/machinery/atmospherics/pipe/simple/scrubbers/hidden/layer1{
	dir = 10
	},
/turf/open/floor/plasteel,
/area/ruin/powered)
"wX" = (
/obj/machinery/atmospherics/pipe/simple/supply/hidden/layer3,
/obj/machinery/atmospherics/pipe/simple/scrubbers/hidden/layer1,
/turf/open/floor/plasteel,
/area/ruin/powered)
"xc" = (
/obj/machinery/light/small,
/obj/effect/decal/remains/human,
/turf/open/floor/plasteel,
/area/ruin/powered)
"yt" = (
/turf/open/floor/plating/snowed/smoothed/icemoon,
/area/icemoon/surface/outdoors)
"yB" = (
/obj/machinery/light,
/turf/open/floor/plasteel/yellowsiding{
	dir = 9
	},
/area/icemoon/surface/outdoors)
"zb" = (
/obj/structure/table/reinforced,
/obj/item/storage/fancy/cigarettes/cigars,
/obj/item/storage/fancy/cigarettes/cigars{
	pixel_x = 2;
	pixel_y = 2
	},
/obj/item/storage/fancy/cigarettes/cigars{
	pixel_x = 4;
	pixel_y = 4
	},
/obj/machinery/light{
	dir = 4
	},
/turf/open/floor/plasteel,
/area/ruin/powered)
"zZ" = (
/obj/machinery/power/smes,
/obj/structure/cable{
	icon_state = "0-8"
	},
/turf/open/floor/plating,
/area/ruin/powered)
"AR" = (
/obj/machinery/atmospherics/pipe/simple/supply/hidden/layer3{
	dir = 4
	},
/obj/machinery/atmospherics/pipe/manifold/scrubbers/hidden/layer1{
	dir = 1
	},
/turf/open/floor/plasteel,
/area/ruin/powered)
"AU" = (
/obj/machinery/atmospherics/pipe/simple/supply/hidden/layer3,
/obj/machinery/atmospherics/pipe/manifold/scrubbers/hidden/layer1{
	dir = 4
	},
/turf/open/floor/plasteel/showroomfloor,
/area/ruin/powered)
"Ba" = (
/obj/machinery/atmospherics/pipe/simple/supply/hidden/layer3{
	dir = 10
	},
/obj/machinery/atmospherics/components/unary/vent_scrubber/on/layer1{
	dir = 8
	},
/turf/open/floor/plasteel,
/area/ruin/powered)
"Bb" = (
/obj/effect/spawner/structure/window/reinforced,
/turf/open/floor/plating,
/area/ruin/powered)
"Bu" = (
/obj/machinery/atmospherics/components/unary/vent_pump/on/layer3,
/turf/open/floor/plasteel,
/area/ruin/powered)
"Di" = (
/obj/structure/table/reinforced,
/obj/structure/window/reinforced{
	dir = 8
	},
/obj/item/storage/fancy/donut_box{
	pixel_y = 10
	},
/obj/item/storage/fancy/donut_box{
	pixel_y = 2
	},
/turf/open/floor/plasteel,
/area/ruin/powered)
"DA" = (
/obj/machinery/door/window/northleft{
	name = "Cooler Door"
	},
/obj/structure/rack,
/obj/item/reagent_containers/food/drinks/soda_cans/maint_energy/megaflavor{
	pixel_x = -9;
	pixel_y = 6
	},
/obj/item/reagent_containers/food/drinks/soda_cans/maint_energy/megaflavor{
	pixel_x = -9
	},
/obj/item/reagent_containers/food/drinks/soda_cans/maint_energy/megaflavor{
	pixel_x = -9;
	pixel_y = -6
	},
/obj/item/reagent_containers/food/drinks/soda_cans/maint_energy/zero_fusion{
	pixel_y = 6
	},
/obj/item/reagent_containers/food/drinks/soda_cans/maint_energy/zero_fusion,
/obj/item/reagent_containers/food/drinks/soda_cans/maint_energy/zero_fusion{
	pixel_y = -6
	},
/obj/item/reagent_containers/food/drinks/soda_cans/maint_energy{
	pixel_x = 9;
	pixel_y = 6
	},
/obj/item/reagent_containers/food/drinks/soda_cans/maint_energy{
	pixel_x = 9
	},
/obj/item/reagent_containers/food/drinks/soda_cans/maint_energy{
	pixel_x = 9;
	pixel_y = -6
	},
/obj/machinery/atmospherics/pipe/simple/supply/hidden/layer3,
/obj/machinery/atmospherics/pipe/simple/scrubbers/hidden/layer1,
/turf/open/floor/plating,
/area/ruin/powered)
"DH" = (
/obj/structure/rack,
/obj/item/toy/plush/lizardplushie{
	pixel_x = -8
	},
/obj/item/toy/plush/lizardplushie,
/obj/item/toy/plush/lizardplushie{
	pixel_x = 8
	},
/turf/open/floor/plasteel,
/area/ruin/powered)
"DJ" = (
/obj/structure/sink{
	dir = 8;
	pixel_x = -12;
	pixel_y = 2
	},
/obj/structure/mirror{
	pixel_x = -28
	},
/turf/open/floor/plasteel,
/area/ruin/powered)
"DW" = (
/obj/effect/turf_decal/tile/bar,
/obj/effect/turf_decal/tile/bar{
	dir = 1
	},
/obj/structure/chair{
	dir = 8
	},
/turf/open/floor/plasteel,
/area/ruin/powered)
"En" = (
/obj/structure/rack,
/obj/item/reagent_containers/food/snacks/cannedpeaches{
	pixel_x = 5
	},
/obj/item/reagent_containers/food/snacks/cannedpeaches{
	pixel_x = -5;
	pixel_y = 5
	},
/obj/item/reagent_containers/food/snacks/cannedpeaches,
/turf/open/floor/plasteel,
/area/ruin/powered)
"ET" = (
/obj/machinery/atmospherics/pipe/simple/supply/hidden/layer3{
	dir = 5
	},
/obj/machinery/atmospherics/pipe/simple/scrubbers/hidden/layer1{
	dir = 6
	},
/turf/open/floor/plasteel,
/area/ruin/powered)
"EY" = (
/obj/structure/table/wood,
/obj/machinery/chem_dispenser/drinks{
	dir = 8
	},
/obj/effect/turf_decal/tile/bar,
/obj/effect/turf_decal/tile/bar{
	dir = 1
	},
/turf/open/floor/plasteel,
/area/ruin/powered)
"EZ" = (
/obj/machinery/atmospherics/pipe/simple/supply/hidden{
	dir = 6
	},
/obj/machinery/meter,
/turf/open/floor/plating,
/area/ruin/powered)
"FN" = (
/obj/machinery/atmospherics/pipe/simple/scrubbers/hidden/layer1{
	dir = 9
	},
/obj/structure/rack,
/obj/item/reagent_containers/food/drinks/bottle/absinthe{
	pixel_x = -8
	},
/obj/item/reagent_containers/food/drinks/bottle/absinthe,
/obj/item/reagent_containers/food/drinks/bottle/absinthe{
	pixel_x = 8
	},
/turf/open/floor/plasteel,
/area/ruin/powered)
"GX" = (
/obj/machinery/door/window/northleft{
	name = "Cooler Door"
	},
/obj/structure/rack,
/obj/item/reagent_containers/food/drinks/bottle/sake{
	pixel_x = 7
	},
/obj/item/reagent_containers/food/drinks/bottle/sake,
/obj/item/reagent_containers/food/drinks/bottle/sake{
	pixel_x = -6
	},
/turf/open/floor/plating,
/area/ruin/powered)
"HZ" = (
/obj/structure/cable{
	icon_state = "4-8"
	},
/turf/open/floor/plating,
/area/ruin/powered)
"Ia" = (
/obj/structure/rack,
/obj/item/reagent_containers/food/condiment/rice{
	list_reagents = list(/datum/reagent/consumable/rice = 90);
	name = "large rice sack";
	pixel_x = -10;
	possible_transfer_amounts = list(1,5,10,15,20,25,30,50,60,90)
	},
/obj/item/reagent_containers/food/condiment/rice{
	list_reagents = list(/datum/reagent/consumable/rice = 90);
	name = "large rice sack";
	pixel_x = -6;
	possible_transfer_amounts = list(1,5,10,15,20,25,30,50,60,90)
	},
/obj/item/reagent_containers/food/condiment/rice{
	list_reagents = list(/datum/reagent/consumable/rice = 90);
	name = "large rice sack";
	possible_transfer_amounts = list(1,5,10,15,20,25,30,50,60,90)
	},
/turf/open/floor/plasteel,
/area/ruin/powered)
"IB" = (
/obj/structure/table/reinforced,
/obj/item/storage/fancy/cigarettes/cigpack_robustgold{
	pixel_x = 1;
	pixel_y = 4
	},
/obj/item/storage/fancy/cigarettes/cigpack_robustgold{
	pixel_x = -1;
	pixel_y = 2
	},
/obj/item/storage/fancy/cigarettes/cigpack_robustgold{
	pixel_x = -3
	},
/obj/item/storage/fancy/cigarettes/cigpack_robustgold{
	pixel_x = -5;
	pixel_y = -2
	},
/obj/item/storage/fancy/cigarettes/cigpack_uplift{
	pixel_x = 9;
	pixel_y = 4
	},
/obj/item/storage/fancy/cigarettes/cigpack_uplift{
	pixel_x = 7;
	pixel_y = 2
	},
/obj/item/storage/fancy/cigarettes/cigpack_uplift{
	pixel_x = 5
	},
/obj/item/storage/fancy/cigarettes/cigpack_uplift{
	pixel_x = 3;
	pixel_y = -2
	},
/turf/open/floor/plasteel,
/area/ruin/powered)
"IE" = (
/obj/structure/reagent_dispensers/beerkeg,
/turf/open/floor/plasteel/showroomfloor,
/area/ruin/powered)
"IW" = (
/turf/open/floor/plating,
/area/ruin/powered)
"KI" = (
/obj/structure/rack,
/obj/item/mop,
/obj/item/broom,
/obj/item/reagent_containers/spray/cleaner{
	pixel_x = -11
	},
/obj/item/reagent_containers/glass/bucket,
/turf/open/floor/plating,
/area/ruin/powered)
"KL" = (
/turf/open/floor/plasteel/yellowsiding{
	dir = 5
	},
/area/icemoon/surface/outdoors)
"Lp" = (
/obj/structure/rack,
/obj/item/storage/firstaid/regular{
	pixel_x = -5;
	pixel_y = 5
	},
/obj/item/storage/firstaid/regular,
/obj/item/storage/firstaid/regular{
	pixel_x = 5;
	pixel_y = -5
	},
/turf/open/floor/plasteel,
/area/ruin/powered)
"Lv" = (
/obj/machinery/door/airlock{
	name = "Bathroom Stall"
	},
/turf/open/floor/plasteel,
/area/ruin/powered)
"LF" = (
/obj/structure/rack,
/obj/item/reagent_containers/food/drinks/dry_ramen,
/obj/item/reagent_containers/food/drinks/dry_ramen{
	pixel_x = 10
	},
/obj/item/reagent_containers/food/drinks/dry_ramen{
	pixel_x = 4
	},
/obj/item/reagent_containers/food/drinks/dry_ramen{
	pixel_x = -4
	},
/turf/open/floor/plasteel,
/area/ruin/powered)
"LQ" = (
/obj/structure/table/reinforced,
/obj/structure/window/reinforced{
	dir = 8
	},
/obj/item/reagent_containers/food/drinks/britcup{
	pixel_x = -4;
	pixel_y = 8
	},
/obj/item/reagent_containers/food/drinks/britcup{
	pixel_x = -4;
	pixel_y = 1
	},
/obj/item/reagent_containers/food/drinks/britcup{
	pixel_x = -4;
	pixel_y = -6
	},
/turf/open/floor/plasteel,
/area/ruin/powered)
"Mg" = (
/obj/effect/turf_decal/tile/bar,
/obj/effect/turf_decal/tile/bar{
	dir = 1
	},
/obj/structure/chair{
	dir = 4
	},
/turf/open/floor/plasteel,
/area/ruin/powered)
"Nm" = (
/obj/machinery/light{
	dir = 4
	},
/turf/open/floor/plasteel,
/area/ruin/powered)
"Nw" = (
/obj/machinery/door/window/northleft{
	name = "Cooler Door"
	},
/obj/structure/rack,
/obj/item/reagent_containers/food/drinks/bottle/vodka/badminka{
	pixel_x = 5
	},
/obj/item/reagent_containers/food/drinks/bottle/vodka/badminka,
/obj/item/reagent_containers/food/drinks/bottle/vodka/badminka{
	pixel_x = -6
	},
/turf/open/floor/plating,
/area/ruin/powered)
"ND" = (
/turf/open/floor/plating/asteroid/snow/icemoon,
/area/icemoon/surface/outdoors)
"Od" = (
/obj/structure/rack,
/obj/item/reagent_containers/glass/beaker/waterbottle/large{
	pixel_x = 6
	},
/obj/item/reagent_containers/glass/beaker/waterbottle/large,
/obj/item/reagent_containers/glass/beaker/waterbottle/large{
	pixel_x = -6
	},
/turf/open/floor/plasteel,
/area/ruin/powered)
"OB" = (
/obj/structure/cable{
	icon_state = "1-2"
	},
/obj/machinery/atmospherics/pipe/layer_manifold{
	dir = 4
	},
/turf/open/floor/plasteel,
/area/ruin/powered)
"OJ" = (
/obj/machinery/atmospherics/pipe/manifold/supply/hidden/layer3,
/obj/machinery/atmospherics/pipe/simple/scrubbers/hidden/layer1{
	dir = 5
	},
/turf/open/floor/plasteel/showroomfloor,
/area/ruin/powered)
"PN" = (
/obj/structure/table/reinforced,
/turf/open/floor/plasteel,
/area/ruin/powered)
"SW" = (
/obj/machinery/atmospherics/components/unary/vent_scrubber/on/layer1{
	dir = 1
	},
/turf/open/floor/plasteel,
/area/ruin/powered)
"Td" = (
/obj/machinery/atmospherics/pipe/manifold/supply/hidden,
/turf/open/floor/plating,
/area/ruin/powered)
"TL" = (
/turf/closed/wall,
/area/ruin/powered)
"Ua" = (
/obj/structure/table/reinforced,
/obj/machinery/door/window/northleft{
	name = "Attendant Window"
	},
/turf/open/floor/plating,
/area/ruin/powered)
"Ud" = (
/turf/template_noop,
/area/template_noop)
"Uf" = (
/obj/machinery/atmospherics/pipe/simple/scrubbers/hidden{
	dir = 4
	},
/turf/open/floor/plating/asteroid/snow/icemoon,
/area/icemoon/surface/outdoors)
"Up" = (
/obj/machinery/atmospherics/components/unary/outlet_injector/on{
	dir = 4
	},
/turf/open/floor/plating/asteroid/snow/icemoon,
/area/icemoon/surface/outdoors)
"Ux" = (
/obj/machinery/light/small,
/obj/machinery/atmospherics/components/unary/vent_pump/on/layer3{
	dir = 1
	},
/turf/open/floor/plasteel,
/area/ruin/powered)
"Vb" = (
/obj/machinery/atmospherics/pipe/simple/supply/hidden/layer3{
	dir = 4
	},
/turf/open/floor/plasteel,
/area/ruin/powered)
"Vx" = (
/obj/structure/rack,
/obj/item/reagent_containers/food/drinks/dry_ramen{
	pixel_x = 4
	},
/obj/item/reagent_containers/food/drinks/dry_ramen{
	pixel_x = 10
	},
/obj/item/reagent_containers/food/drinks/dry_ramen{
	pixel_x = -4
	},
/obj/item/reagent_containers/food/drinks/dry_ramen,
/turf/open/floor/plasteel,
/area/ruin/powered)
"VE" = (
/obj/structure/table/wood,
/obj/effect/turf_decal/tile/bar,
/obj/effect/turf_decal/tile/bar{
	dir = 1
	},
/obj/machinery/microwave{
	pixel_x = -3;
	pixel_y = 6
	},
/obj/machinery/light{
	dir = 4
	},
/turf/open/floor/plasteel,
/area/ruin/powered)
"Ww" = (
/obj/machinery/atmospherics/pipe/simple/supply/hidden/layer3{
	dir = 6
	},
/obj/machinery/atmospherics/pipe/simple/scrubbers/hidden/layer1{
	dir = 6
	},
/turf/open/floor/plasteel,
/area/ruin/powered)
"Wy" = (
/obj/structure/toilet,
/turf/open/floor/plasteel,
/area/ruin/powered)
"Xw" = (
/obj/machinery/door/airlock/public/glass{
	name = "Gas Station"
	},
/obj/structure/fans/tiny,
/turf/open/floor/plasteel,
/area/ruin/powered)
"XA" = (
/obj/structure/cable{
	icon_state = "1-2"
	},
/turf/open/floor/plasteel,
/area/ruin/powered)
"XZ" = (
/obj/machinery/atmospherics/components/unary/vent_pump/on/layer3{
	dir = 4
	},
/turf/open/floor/plasteel/showroomfloor,
/area/ruin/powered)
"Ye" = (
/obj/machinery/computer/arcade/tetris{
	dir = 1
	},
/turf/open/floor/plasteel,
/area/ruin/powered)
"YT" = (
/turf/open/floor/plasteel/yellowsiding{
	dir = 1
	},
/area/icemoon/surface/outdoors)
"ZE" = (
/obj/machinery/door/airlock{
	name = "Checkout Counter"
	},
/turf/open/floor/plasteel,
/area/ruin/powered)
"ZN" = (
/obj/structure/reagent_dispensers/watertank/high,
/turf/open/floor/plating,
/area/ruin/powered)
"ZZ" = (
/turf/open/floor/plasteel,
/area/ruin/powered)

(1,1,1) = {"
Ud
Ud
Ud
ay
ay
ay
ay
ay
ay
ay
ay
ay
ay
ay
ay
ay
ay
ay
ay
ay
Ud
Ud
Ud
Ud
Ud
"}
(2,1,1) = {"
Ud
Ud
Ud
ay
ND
ND
ND
ND
ND
ay
ay
ay
ay
ay
ay
ay
ay
ay
ND
ND
ND
ND
Ud
Ud
Ud
"}
(3,1,1) = {"
Ud
Ud
ND
ND
ND
ND
ND
yB
TL
TL
TL
TL
TL
TL
TL
TL
TL
TL
TL
TL
TL
ND
ND
Ud
Ud
"}
(4,1,1) = {"
Ud
Ud
ND
ND
yt
yt
yt
YT
Bb
ZZ
eo
ZZ
ZZ
ZZ
eo
ZZ
ZZ
fD
az
IE
TL
ND
ND
Ud
Ud
"}
(5,1,1) = {"
Ud
Ud
ND
ND
yt
yt
yt
YT
Bb
ZZ
rR
En
ds
Lp
Od
DH
ZZ
Nw
tF
IE
TL
ND
ND
ND
Ud
"}
(6,1,1) = {"
Ud
Ud
ND
ND
yt
yt
yt
YT
Bb
ZZ
ZZ
ZZ
Bu
ET
SW
ZZ
ZZ
GX
tF
tF
TL
ND
ND
ND
Ud
"}
(7,1,1) = {"
Ud
Ud
ND
ND
yt
yt
yt
YT
Xw
ZZ
pN
Vx
sm
jq
dB
rU
ZZ
nM
qN
XZ
TL
Up
ND
ND
Ud
"}
(8,1,1) = {"
Ud
ND
ND
ND
yt
yt
yt
YT
Bb
ZZ
ZZ
ZZ
ZZ
wO
wX
ec
wX
DA
AU
OJ
TL
Uf
ND
ND
ay
"}
(9,1,1) = {"
Ud
ND
ND
ND
yt
yt
yt
YT
Xw
ZZ
ZZ
ZZ
ZZ
ZZ
ZZ
Vb
Ye
TL
TL
fy
TL
mR
TL
ND
ay
"}
(10,1,1) = {"
Ud
ND
ND
ND
ND
ND
ND
YT
TL
Di
PN
LQ
jh
rH
rH
tJ
Mg
TL
LF
AR
fr
FN
TL
ND
ay
"}
(11,1,1) = {"
Ud
ND
ND
ND
yt
yt
yt
YT
Ua
ZZ
ZZ
ZZ
wJ
rH
rH
tJ
mE
TL
ZZ
iv
ZZ
xc
TL
ay
ay
"}
(12,1,1) = {"
Ud
ay
ND
ND
yt
yt
yt
YT
TL
IB
zb
ZZ
kM
EY
VE
tJ
DW
TL
Ww
aW
oS
Ia
TL
ay
Ud
"}
(13,1,1) = {"
Ud
ay
ND
ND
yt
yt
yt
sK
TL
TL
TL
ZE
TL
TL
TL
Vb
TL
TL
fi
TL
TL
TL
TL
ay
Ud
"}
(14,1,1) = {"
Ud
ay
ay
ND
yt
yt
yt
KL
qO
rc
TL
py
XA
mk
XA
OB
gF
Nm
wO
kn
in
DJ
TL
ay
Ud
"}
(15,1,1) = {"
Ud
ay
ay
ND
yt
yt
yt
ND
ND
YT
TL
IW
IW
TL
EZ
Td
HZ
TL
TL
TL
Ba
Ux
TL
ay
Ud
"}
(16,1,1) = {"
Ud
ay
ay
ND
yt
yt
yt
ND
ND
YT
TL
ZN
KI
TL
rn
mV
zZ
TL
Wy
Lv
rs
ZZ
TL
ay
Ud
"}
(17,1,1) = {"
Ud
ay
ay
ND
ND
ND
ND
ND
ND
KL
TL
TL
TL
TL
TL
TL
TL
TL
TL
TL
TL
TL
TL
ay
Ud
"}
(18,1,1) = {"
Ud
Ud
ay
ay
ND
ND
ND
ND
ND
ND
ND
ND
ay
ay
ay
ay
ay
ay
ay
ay
ay
ay
ay
ay
Ud
"}
(19,1,1) = {"
Ud
Ud
Ud
Ud
Ud
Ud
Ud
ND
ND
ND
ND
ay
ay
ay
ay
ay
ay
ay
ay
ay
ay
Ud
Ud
Ud
Ud
"}
(20,1,1) = {"
Ud
Ud
Ud
Ud
Ud
Ud
Ud
Ud
Ud
Ud
ay
ay
ay
ay
ay
ay
ay
ay
Ud
Ud
Ud
Ud
Ud
Ud
Ud
"}
