"a" = (/turf/closed/wall/r_wall/rust,/area/ruin/unpowered)
"i" = (/obj/machinery/door/poddoor{id = "bearscage"},/turf/open/floor/mineral/plastitanium/red,/area/ruin/unpowered)
"l" = (/obj/machinery/button/door{id = "bearscage"; name = "release bears"; pixel_x = -26; pixel_y = 6; req_access_txt = "20"},/obj/structure/lattice/catwalk,/turf/template_noop,/area/ruin/unpowered)
"m" = (/obj/structure/lattice/catwalk,/turf/template_noop,/area/ruin/unpowered)
"o" = (/obj/item/broken_bottle,/turf/open/floor/mineral/plastitanium/red,/area/ruin/unpowered)
"t" = (/mob/living/simple_animal/hostile/bear,/turf/open/floor/mineral/plastitanium/red,/area/ruin/unpowered)
"x" = (/turf/closed/wall/r_wall,/area/ruin/unpowered)
"B" = (/obj/effect/decal/hammerandsickle,/turf/open/floor/mineral/plastitanium/red,/area/ruin/unpowered)
"F" = (/obj/effect/decal/cleanable/blood/old,/turf/open/floor/mineral/plastitanium/red,/area/ruin/unpowered)
"I" = (/mob/living/simple_animal/hostile/bear{dir = 1},/turf/open/floor/engine,/area/ruin/unpowered)
"K" = (/turf/closed/wall/rust,/area/ruin/unpowered)
"N" = (/obj/machinery/door/airlock/hatch{name = "Medved Konteyner"},/obj/structure/fans/tiny,/turf/open/floor/engine,/area/ruin/unpowered)
"R" = (/turf/open/floor/engine,/area/ruin/unpowered)
"T" = (/turf/open/floor/mineral/plastitanium/red,/area/ruin/unpowered)
"W" = (/mob/living/simple_animal/hostile/bear{dir = 8},/turf/open/floor/mineral/plastitanium/red,/area/ruin/unpowered)
"X" = (/obj/item/kitchen/knife,/turf/open/floor/mineral/plastitanium/red,/area/ruin/unpowered)
"Z" = (/mob/living/simple_animal/hostile/bear{dir = 4},/turf/open/floor/mineral/plastitanium/red,/area/ruin/unpowered)

(1,1,1) = {"
axxxaxm
aITTTal
iTotFaa
iFBTTRN
iZTTXxx
xRFWTam
aaxKaam
"}
