"a" = (/turf/template_noop,/area/template_noop)
"g" = (/turf/closed/mineral,/area/ruin/unpowered)

(1,1,1) = {"
aaaagaa
aggaaaa
aggaaga
aaaaaaa
agagaag
agaagaa
aaaaaag
"}
