"a" = (/turf/closed/wall,/area/ruin/unpowered)
"b" = (/turf/open/floor/plasteel,/area/ruin/unpowered)
"d" = (/obj/structure/closet/crate/medical,/turf/open/floor/plasteel,/area/ruin/unpowered)
"e" = (/obj/structure/spider/stickyweb/genetic,/obj/effect/decal/remains/xeno,/turf/open/floor/plasteel,/area/ruin/unpowered)
"g" = (/obj/structure/rack,/obj/item/clothing/head/soft,/obj/structure/spider/stickyweb/genetic,/turf/open/floor/plasteel,/area/ruin/unpowered)
"j" = (/obj/structure/rack,/turf/open/floor/plasteel,/area/ruin/unpowered)
"l" = (/obj/structure/closet/crate/internals,/obj/structure/spider/stickyweb/genetic,/turf/open/floor/plasteel,/area/ruin/unpowered)
"v" = (/obj/structure/rack,/obj/item/clothing/head/soft,/mob/living/simple_animal/hostile/poison/giant_spider{dir = 1},/turf/open/floor/plasteel,/area/ruin/unpowered)
"y" = (/obj/structure/chair/comfy/plywood{dir = 1},/obj/structure/spider/stickyweb/genetic,/turf/open/floor/plasteel,/area/ruin/unpowered)
"D" = (/obj/machinery/door/airlock/mining/glass{name = "Cargo Pod 523"; req_access_txt = "31"},/turf/open/floor/plasteel,/area/ruin/unpowered)
"E" = (/obj/structure/closet/crate/medical,/obj/structure/spider/stickyweb/genetic,/turf/open/floor/plasteel,/area/ruin/unpowered)
"I" = (/obj/effect/decal/remains/human,/turf/open/floor/plasteel,/area/ruin/unpowered)
"J" = (/obj/structure/chair/comfy/plywood{dir = 4},/obj/structure/sign/poster/official/spiderlings{pixel_y = 32},/turf/open/floor/plasteel,/area/ruin/unpowered)
"N" = (/obj/structure/closet/crate/internals,/turf/open/floor/plasteel,/area/ruin/unpowered)
"S" = (/obj/structure/spider/stickyweb/genetic,/turf/open/floor/plasteel,/area/ruin/unpowered)

(1,1,1) = {"
aaaaaaa
aSSJEda
aISSSSa
DbgvjSD
alSbSSa
aNySlea
aaaaaaa
"}
