"a" = (/turf/template_noop,/area/template_noop)
"h" = (/obj/structure/alien/weeds,/mob/living/simple_animal/hostile/alien/drone,/turf/open/floor/plating/asteroid/airless,/area/ruin/unpowered)
"i" = (/obj/structure/alien/weeds,/obj/effect/decal/cleanable/blood/xeno,/turf/open/floor/plating/asteroid/airless,/area/ruin/unpowered)
"t" = (/obj/structure/alien/weeds,/obj/structure/bed/nest,/turf/open/floor/plating/asteroid/airless,/area/ruin/unpowered)
"z" = (/obj/structure/alien/weeds,/obj/structure/alien/egg/burst,/obj/item/clothing/mask/facehugger/impregnated,/turf/open/floor/plating/asteroid/airless,/area/ruin/unpowered)
"A" = (/obj/structure/alien/weeds,/obj/structure/alien/egg/burst,/obj/effect/decal/cleanable/blood/xeno,/turf/open/floor/plating/asteroid/airless,/area/ruin/unpowered)
"F" = (/obj/structure/alien/weeds,/obj/structure/alien/weeds/node,/obj/effect/decal/remains/human,/turf/open/floor/plating/asteroid/airless,/area/ruin/unpowered)
"M" = (/obj/structure/alien/resin/wall,/obj/structure/alien/weeds,/turf/open/floor/plating/asteroid/airless,/area/ruin/unpowered)
"Q" = (/obj/structure/alien/weeds,/turf/open/floor/plating/asteroid/airless,/area/ruin/unpowered)
"V" = (/obj/structure/alien/weeds,/obj/effect/mob_spawn/alien/corpse/humanoid/queen,/turf/open/floor/plating/asteroid/airless,/area/ruin/unpowered)
"X" = (/obj/structure/alien/weeds,/obj/structure/bed/nest,/mob/living/simple_animal/hostile/alien/drone{dir = 8},/turf/open/floor/plating/asteroid/airless,/area/ruin/unpowered)

(1,1,1) = {"
MMaaaaa
MMMMMMa
MtFhtzM
MMiQVQM
aMXzQMM
aMMMAMa
aaaMMMa
"}
