"a" = (/turf/template_noop,/area/template_noop)
"f" = (/mob/living/simple_animal/hostile/carp{desc = "A extremely hostile form of astrofauna, bearing a strong resemblance to a fish."; dir = 4},/turf/open/floor/plating/asteroid/airless,/area/ruin/unpowered)
"z" = (/turf/closed/mineral/random/high_chance,/area/ruin/unpowered)
"C" = (/mob/living/simple_animal/hostile/carp{desc = "A extremely hostile form of astrofauna, bearing a strong resemblance to a fish."; dir = 8},/turf/open/floor/plating/asteroid/airless,/area/ruin/unpowered)
"H" = (/turf/open/floor/plating/asteroid/airless,/area/ruin/unpowered)
"N" = (/obj/item/clothing/suit/space/hardsuit/carp,/obj/item/clothing/head/helmet/space/hardsuit/carp,/obj/item/clothing/mask/gas/carp,/turf/open/floor/plating/asteroid/airless,/area/ruin/unpowered)

(1,1,1) = {"
aaazzza
aHHzzza
aHHHHzz
zHHHCHz
zzfHHzz
zzHNzza
azzzzaa
"}
