"a" = (/turf/template_noop,/area/template_noop)
"u" = (/turf/open/floor/plating/asteroid/airless,/area/ruin/unpowered)
"v" = (/mob/living/simple_animal/hostile/asteroid/basilisk{desc = "A somewhat common species of astrofauna. Utilizes a bodily mechanism that causes painful freezing in its prey."},/turf/open/floor/plating/asteroid/airless,/area/ruin/unpowered)
"w" = (/turf/closed/mineral,/area/ruin/unpowered)

(1,1,1) = {"
aawwaaa
awwwwwa
awuuwwa
wwuvuww
wuuwwww
wwuuwwa
awwwwaa
"}
