"a" = (/turf/template_noop,/area/template_noop)
"r" = (/turf/closed/mineral/random/high_chance,/area/ruin/unpowered)
"O" = (/turf/closed/mineral/gold,/area/ruin/unpowered)

(1,1,1) = {"
arrrraa
rrrOrrr
rOOOOrr
rrOOOra
arOOOrr
arrOrrr
aarrrra
"}
