"a" = (/turf/template_noop,/area/template_noop)
"g" = (/mob/living/simple_animal/opossum,/turf/open/floor/plating,/area/ruin/unpowered)
"h" = (/obj/structure/fans/tiny,/obj/machinery/door/airlock/hatch,/turf/open/floor/plating,/area/ruin/unpowered)
"m" = (/mob/living/simple_animal/opossum{dir = 8},/turf/open/floor/plating,/area/ruin/unpowered)
"t" = (/mob/living/simple_animal/opossum,/obj/item/reagent_containers/food/condiment/pack/ketchup,/turf/open/floor/plating,/area/ruin/unpowered)
"u" = (/obj/structure/trash_pile,/turf/open/floor/plating,/area/ruin/unpowered)
"w" = (/obj/item/clothing/head/papersack,/obj/structure/trash_pile,/turf/open/floor/plating,/area/ruin/unpowered)
"x" = (/mob/living/simple_animal/opossum{dir = 1},/turf/open/floor/plating,/area/ruin/unpowered)
"z" = (/mob/living/simple_animal/opossum{dir = 4},/turf/open/floor/plating,/area/ruin/unpowered)
"D" = (/turf/open/floor/plating,/area/ruin/unpowered)
"O" = (/turf/closed/wall/mineral/plastitanium,/area/ruin/unpowered)

(1,1,1) = {"
aaaaaaa
OOOOOOO
OxuzwgO
hDxmtDh
OuzzuuO
OOOOOOO
aaaaaaa
"}
