"a" = (/turf/closed/mineral,/area/space)
"b" = (/obj/structure/chair{dir = 4},/obj/effect/decal/remains/human{desc = "They look like human remains. Whoever this was had some sick hair."},/turf/open/floor/plating/asteroid/airless,/area/space)
"f" = (/mob/living/simple_animal/hostile/rat{dir = 4},/turf/open/floor/plating/asteroid/airless,/area/space)
"g" = (/obj/structure/bed,/obj/effect/spawner/lootdrop/bedsheet,/turf/open/floor/plating/asteroid/airless,/area/space)
"s" = (/obj/effect/spawner/structure/window,/turf/open/floor/plating,/area/space)
"u" = (/mob/living/simple_animal/hostile/regalrat{desc = "The biggest rat, he looks like he makes all the rules."; name = "Big Rat"},/turf/open/floor/plating/asteroid/airless,/area/space)
"v" = (/mob/living/simple_animal/hostile/rat,/turf/open/floor/plating/asteroid/airless,/area/space)
"C" = (/mob/living/simple_animal/hostile/rat{dir = 1},/turf/open/floor/plating/asteroid/airless,/area/space)
"E" = (/turf/open/space/basic,/area/space)
"I" = (/obj/machinery/computer{desc = "A computer long since rendered non-functional due to lack of maintenance. Spitting out error messages."; name = "Broken Computer"},/turf/open/floor/plating/asteroid/airless,/area/space)
"J" = (/mob/living/simple_animal/hostile/rat{dir = 8},/turf/open/floor/plating/asteroid/airless,/area/space)
"K" = (/turf/open/floor/plating/asteroid/airless,/area/space)
"T" = (/turf/closed/mineral/random/low_chance,/area/space)
"W" = (/obj/item/reagent_containers/food/drinks/bottle/hcider,/turf/open/floor/plating/asteroid/airless,/area/space)
"X" = (/obj/structure/table,/obj/item/reagent_containers/food/drinks/bottle/hcider,/turf/open/floor/plating/asteroid/airless,/area/space)
"Y" = (/obj/structure/fans/tiny,/obj/machinery/door/airlock/hatch,/turf/open/floor/plating,/area/space)

(1,1,1) = {"
assssaT
TIXKJKT
TbvuKWa
TWKCWga
aKfKKTa
aWKKTTE
aaYaTEE
"}
