"a" = (/turf/template_noop,/area/template_noop)
"b" = (/turf/closed/mineral,/area/ruin/unpowered)

(1,1,1) = {"
aabbaaa
abbbbba
abbbbba
bbbbbbb
bbbbbbb
bbbbbba
abbbbaa
"}
