"a" = (/turf/template_noop,/area/template_noop)
"f" = (/obj/structure/chair/comfy/shuttle{dir = 8; name = "tactical chair"},/turf/open/floor/plasteel/dark,/area/ruin/unpowered)
"g" = (/obj/structure/tank_dispenser,/turf/open/floor/mineral/plastitanium/red,/area/ruin/unpowered)
"j" = (/obj/structure/rack,/obj/item/pickaxe,/obj/item/radio/off,/obj/machinery/light{dir = 8},/turf/open/floor/mineral/plastitanium/red,/area/ruin/unpowered)
"n" = (/turf/closed/wall/mineral/plastitanium/nodiagonal,/area/ruin/unpowered)
"p" = (/obj/structure/chair/comfy/shuttle{name = "tactical chair"},/turf/open/floor/plasteel/dark,/area/ruin/unpowered)
"r" = (/obj/structure/rack,/obj/item/clothing/suit/space/syndicate,/obj/item/pickaxe,/obj/machinery/light{dir = 4},/turf/open/floor/mineral/plastitanium/red,/area/ruin/unpowered)
"u" = (/obj/structure/rack,/obj/item/clothing/suit/space/syndicate,/obj/item/clothing/head/helmet/space/syndicate,/obj/structure/sign/warning/vacuum/external{pixel_y = 32},/turf/open/floor/mineral/plastitanium/red,/area/ruin/unpowered)
"v" = (/obj/machinery/light{dir = 8},/turf/open/floor/mineral/plastitanium/red,/area/ruin/unpowered)
"A" = (/turf/open/floor/mineral/plastitanium/red,/area/ruin/unpowered)
"B" = (/obj/structure/rack,/obj/item/radio/off,/turf/open/floor/mineral/plastitanium/red,/area/ruin/unpowered)
"E" = (/turf/open/floor/plasteel/dark,/area/ruin/unpowered)
"F" = (/obj/structure/chair/comfy/shuttle{dir = 4; name = "tactical chair"},/turf/open/floor/plasteel/dark,/area/ruin/unpowered)
"H" = (/obj/machinery/door/airlock/hatch,/turf/open/floor/plating,/area/ruin/unpowered)
"L" = (/obj/machinery/light{dir = 4},/turf/open/floor/mineral/plastitanium/red,/area/ruin/unpowered)
"Q" = (/obj/structure/grille,/obj/structure/window/plastitanium,/turf/open/floor/plating,/area/ruin/unpowered)
"R" = (/obj/structure/chair/comfy/shuttle{dir = 1; name = "tactical chair"},/turf/open/floor/plasteel/dark,/area/ruin/unpowered)
"V" = (/turf/closed/wall/mineral/plastitanium,/area/ruin/unpowered)

(1,1,1) = {"
aVVHVVa
VnuAgnV
VvERErV
QAfnFAQ
VjEpELV
VnAABnV
aVVHVVa
"}
