"a" = (/turf/template_noop,/area/template_noop)
"m" = (/obj/structure/shuttle/engine/propulsion{dir = 8},/turf/open/floor/plating,/area/ruin/unpowered)
"N" = (/turf/closed/wall/mineral/plastitanium/nodiagonal,/area/ruin/unpowered)

(1,1,1) = {"
aaaaaaa
aaaaaaa
aaaaaaa
mNNNNNN
aaaaaaa
aaaaaaa
aaaaaaa
"}
