"a" = (/turf/template_noop,/area/template_noop)
"k" = (/turf/closed/mineral,/area/ruin/unpowered)
"E" = (/turf/closed/mineral/bscrystal,/area/ruin/unpowered)
"R" = (/turf/closed/mineral/random/high_chance,/area/ruin/unpowered)

(1,1,1) = {"
aaakkaa
aakRREa
aakRRka
aaakkka
akkakka
akkaaaa
aaaaaaa
"}
