"a" = (/turf/template_noop,/area/template_noop)
"m" = (/turf/open/floor/plating/asteroid/airless,/area/ruin/unpowered)
"x" = (/turf/closed/mineral/random/high_chance,/area/ruin/unpowered)
"Y" = (/turf/closed/mineral,/area/ruin/unpowered)

(1,1,1) = {"
mmYYmma
mxxxYma
mYYxxxY
YxxYxYY
YxYmYxY
aYmmmxY
aYYmmma
"}
