"a" = (/turf/template_noop,/area/template_noop)
"K" = (/turf/closed/mineral,/area/ruin/unpowered)
"O" = (/turf/closed/mineral/random/high_chance,/area/ruin/unpowered)

(1,1,1) = {"
aaaaaaa
aaaKKaa
aKKKOKa
aKKOOKa
aKKOKaa
aaKKaaa
aaaaaaa
"}
