//MAP CONVERTED BY dmm2tgm.py THIS HEADER COMMENT PREVENTS RECONVERSION, DO NOT REMOVE
"ax" = (
/obj/effect/decal/cleanable/blood/old,
/obj/effect/decal/cleanable/dirt,
/obj/structure/table,
/obj/item/storage/backpack/duffelbag/med/surgery,
/turf/open/floor/mineral/titanium/blue,
/area/ruin/powered)
"aE" = (
/obj/structure/window/reinforced{
	dir = 8
	},
/obj/structure/chair/comfy/shuttle{
	dir = 4
	},
/turf/open/floor/mineral/plastitanium,
/area/ruin/powered)
"aQ" = (
/obj/effect/decal/cleanable/dirt,
/turf/open/floor/mineral/plastitanium/red/brig,
/area/ruin/powered)
"be" = (
/obj/effect/decal/cleanable/dirt,
/obj/effect/spawner/structure/window/reinforced,
/turf/open/floor/plating,
/area/ruin/powered)
"bD" = (
/obj/effect/decal/cleanable/dirt,
/turf/open/floor/mineral/plastitanium,
/area/ruin/powered)
"bI" = (
/turf/closed/wall/rust,
/area/ruin/powered)
"bN" = (
/obj/machinery/light/small{
	dir = 4
	},
/turf/open/floor/mineral/plastitanium/red,
/area/ruin/powered)
"cj" = (
/obj/machinery/light{
	dir = 4
	},
/obj/effect/decal/cleanable/dirt,
/turf/open/floor/mineral/titanium/blue,
/area/ruin/powered)
"cq" = (
/obj/structure/table,
/obj/item/stack/medical/suture{
	pixel_x = 5;
	pixel_y = 5
	},
/obj/item/stack/medical/suture,
/obj/structure/extinguisher_cabinet{
	pixel_x = 27
	},
/turf/open/floor/mineral/plastitanium,
/area/ruin/powered)
"cx" = (
/obj/structure/closet/emcloset,
/turf/open/floor/mineral/plastitanium/red,
/area/ruin/powered)
"cO" = (
/obj/effect/decal/cleanable/dirt,
/mob/living/simple_animal/bot/medbot{
	name = "old medibot"
	},
/turf/open/floor/mineral/titanium/white,
/area/ruin/powered)
"dy" = (
/obj/machinery/light/small{
	brightness = 3;
	dir = 8
	},
/turf/open/floor/mineral/plastitanium,
/area/ruin/powered)
"dD" = (
/obj/structure/extinguisher_cabinet{
	pixel_x = 27
	},
/obj/machinery/vending/sovietsoda,
/turf/open/floor/plating,
/area/ruin/powered)
"dK" = (
/obj/effect/decal/cleanable/oil,
/turf/open/floor/plating,
/area/ruin/powered)
"eF" = (
/obj/structure/table,
/obj/effect/decal/cleanable/dirt,
/turf/open/floor/mineral/plastitanium,
/area/ruin/powered)
"fp" = (
/obj/structure/chair/comfy/shuttle{
	dir = 4
	},
/obj/structure/window/reinforced{
	dir = 8
	},
/obj/effect/decal/cleanable/dirt,
/turf/open/floor/mineral/plastitanium,
/area/ruin/powered)
"fB" = (
/obj/structure/table,
/obj/item/shovel,
/turf/open/floor/mineral/plastitanium,
/area/ruin/powered)
"gU" = (
/obj/effect/decal/cleanable/dirt,
/obj/effect/decal/cleanable/blood/tracks{
	dir = 5
	},
/turf/open/floor/mineral/plastitanium/red,
/area/ruin/powered)
"jA" = (
/obj/structure/table,
/obj/item/storage/firstaid/fire,
/turf/open/floor/mineral/titanium/blue,
/area/ruin/powered)
"jB" = (
/obj/structure/extinguisher_cabinet{
	pixel_y = -30
	},
/turf/open/floor/mineral/plastitanium/red,
/area/ruin/powered)
"kh" = (
/obj/effect/mob_spawn/human/corpse/russian/ranged/officer,
/turf/open/floor/mineral/plastitanium/red/brig,
/area/ruin/powered)
"ko" = (
/obj/structure/extinguisher_cabinet{
	pixel_x = -5;
	pixel_y = 30
	},
/obj/effect/decal/cleanable/blood/tracks{
	dir = 4
	},
/turf/open/floor/mineral/plastitanium/red,
/area/ruin/powered)
"li" = (
/obj/machinery/door/airlock/security/glass{
	name = "Infirmary"
	},
/turf/open/floor/mineral/plastitanium,
/area/ruin/powered)
"lm" = (
/obj/structure/chair/comfy/shuttle{
	dir = 1
	},
/turf/open/floor/mineral/titanium,
/area/ruin/powered)
"lo" = (
/obj/effect/decal/cleanable/dirt,
/turf/open/floor/mineral/plastitanium/red,
/area/ruin/powered)
"lC" = (
/obj/effect/decal/cleanable/vomit/old,
/turf/open/floor/mineral/plastitanium/red,
/area/ruin/powered)
"lU" = (
/obj/effect/decal/cleanable/blood/tracks,
/turf/open/floor/mineral/plastitanium/red,
/area/ruin/powered)
"mr" = (
/obj/effect/decal/cleanable/dirt,
/turf/open/floor/mineral/titanium/white,
/area/ruin/powered)
"mt" = (
/obj/machinery/light{
	dir = 1
	},
/obj/effect/decal/cleanable/blood/tracks{
	dir = 8
	},
/turf/open/floor/mineral/plastitanium/red,
/area/ruin/powered)
"mF" = (
/obj/structure/fans/tiny,
/obj/machinery/door/airlock/external/glass,
/turf/open/floor/plating,
/area/ruin/powered)
"mI" = (
/obj/structure/table,
/obj/item/hatchet,
/obj/effect/decal/cleanable/dirt,
/turf/open/floor/mineral/plastitanium,
/area/ruin/powered)
"nr" = (
/obj/effect/decal/cleanable/vomit/old,
/obj/structure/sink{
	dir = 4;
	pixel_x = 11
	},
/turf/open/floor/plating,
/area/ruin/powered)
"nB" = (
/turf/open/floor/mineral/plastitanium/red/brig,
/area/ruin/powered)
"nR" = (
/mob/living/simple_animal/hostile/vadimclone/prisoner/alt,
/turf/open/floor/plating,
/area/ruin/powered)
"oe" = (
/obj/structure/table/reinforced,
/obj/item/reagent_containers/food/snacks/asteroid_worm_raw,
/turf/open/floor/plating,
/area/ruin/powered)
"ox" = (
/obj/structure/chair/comfy/shuttle{
	dir = 4
	},
/obj/effect/decal/cleanable/glass,
/turf/open/floor/mineral/plastitanium,
/area/ruin/powered)
"oz" = (
/obj/machinery/light/small{
	dir = 1
	},
/mob/living/carbon/monkey,
/turf/open/floor/plating,
/area/ruin/powered)
"oJ" = (
/obj/effect/decal/cleanable/dirt,
/obj/machinery/sleeper{
	dir = 8
	},
/turf/open/floor/mineral/titanium/blue,
/area/ruin/powered)
"oL" = (
/obj/effect/decal/cleanable/oil,
/turf/open/floor/mineral/titanium,
/area/ruin/powered)
"oW" = (
/obj/machinery/light/small{
	dir = 4
	},
/obj/structure/closet/emcloset,
/turf/open/floor/mineral/plastitanium,
/area/ruin/powered)
"pr" = (
/obj/machinery/light,
/turf/open/floor/mineral/plastitanium/red,
/area/ruin/powered)
"pO" = (
/obj/effect/decal/cleanable/dirt,
/obj/effect/decal/cleanable/blood/tracks{
	dir = 1
	},
/turf/open/floor/mineral/plastitanium/red,
/area/ruin/powered)
"qG" = (
/obj/structure/chair/comfy/shuttle,
/turf/open/floor/mineral/plastitanium,
/area/ruin/powered)
"rs" = (
/obj/structure/closet/crate,
/obj/item/bedsheet/hos{
	desc = "A basic military blanket, for long military treks.";
	name = "military thermo-cover"
	},
/obj/item/bedsheet/hos{
	desc = "A basic military blanket, for long military treks.";
	name = "military thermo-cover"
	},
/turf/open/floor/mineral/plastitanium,
/area/ruin/powered)
"rw" = (
/obj/effect/decal/cleanable/dirt,
/obj/structure/chair/comfy/shuttle{
	dir = 1
	},
/turf/open/floor/mineral/titanium,
/area/ruin/powered)
"rB" = (
/obj/structure/table,
/obj/item/seeds/cabbage{
	pixel_x = -5
	},
/obj/item/seeds/carrot,
/obj/item/seeds/corn{
	pixel_x = 5
	},
/turf/open/floor/mineral/plastitanium,
/area/ruin/powered)
"sa" = (
/turf/closed/wall/r_wall,
/area/ruin/powered)
"sf" = (
/obj/machinery/hydroponics/constructable,
/turf/open/floor/mineral/plastitanium,
/area/ruin/powered)
"sz" = (
/mob/living/simple_animal/hostile/vadimclone/prisoner/alt,
/turf/open/floor/mineral/plastitanium/red,
/area/ruin/powered)
"tx" = (
/turf/open/floor/plating,
/area/ruin/powered)
"uu" = (
/obj/effect/decal/cleanable/dirt,
/mob/living/simple_animal/hostile/vadimclone/toolbox,
/turf/open/floor/mineral/plastitanium/red,
/area/ruin/powered)
"uH" = (
/obj/structure/bed,
/obj/item/bedsheet/hos{
	desc = "A basic military blanket, for long military treks.";
	name = "military thermo-cover"
	},
/turf/open/floor/mineral/plastitanium,
/area/ruin/powered)
"uX" = (
/turf/open/floor/mineral/titanium,
/area/ruin/powered)
"ve" = (
/obj/machinery/door/airlock/external/glass,
/obj/structure/fans/tiny,
/turf/open/floor/plating,
/area/ruin/powered)
"vL" = (
/obj/structure/window/reinforced{
	dir = 4
	},
/obj/structure/chair/comfy/shuttle{
	dir = 8
	},
/turf/open/floor/mineral/plastitanium,
/area/ruin/powered)
"wu" = (
/obj/effect/decal/cleanable/dirt,
/obj/machinery/light/small{
	brightness = 3;
	dir = 8
	},
/obj/structure/table/optable,
/obj/effect/mob_spawn/human/corpse/russian,
/turf/open/floor/mineral/titanium/blue,
/area/ruin/powered)
"wv" = (
/obj/machinery/door/airlock/security/glass{
	name = "Emergency Shuttle Brig";
	req_access_txt = "2"
	},
/turf/open/floor/mineral/plastitanium,
/area/ruin/powered)
"wP" = (
/obj/effect/decal/cleanable/dirt,
/obj/structure/chair/comfy/shuttle{
	dir = 4
	},
/obj/effect/decal/cleanable/blood/old,
/obj/machinery/light/small{
	brightness = 3;
	dir = 8
	},
/turf/open/floor/mineral/plastitanium/red/brig,
/area/ruin/powered)
"wZ" = (
/obj/effect/decal/cleanable/dirt,
/mob/living/simple_animal/hostile/vadimclone/melee{
	dir = 8
	},
/turf/open/floor/mineral/titanium/white,
/area/ruin/powered)
"xC" = (
/obj/effect/decal/cleanable/dirt,
/obj/structure/chair/comfy/shuttle{
	dir = 8
	},
/turf/open/floor/mineral/plastitanium/red,
/area/ruin/powered)
"yv" = (
/obj/structure/closet,
/turf/open/floor/plating,
/area/ruin/powered)
"yy" = (
/obj/structure/table,
/obj/item/storage/firstaid/brute,
/obj/item/storage/firstaid{
	pixel_x = 2;
	pixel_y = 3
	},
/obj/item/crowbar,
/obj/effect/decal/cleanable/dirt,
/turf/open/floor/mineral/titanium/white,
/area/ruin/powered)
"yP" = (
/obj/structure/chair/comfy/shuttle{
	dir = 8
	},
/obj/effect/decal/cleanable/dirt,
/obj/item/radio/intercom{
	name = "Station Intercom (General)";
	pixel_y = -29
	},
/turf/open/floor/mineral/titanium,
/area/ruin/powered)
"ze" = (
/turf/template_noop,
/area/template_noop)
"zG" = (
/turf/closed/wall,
/area/ruin/powered)
"Bg" = (
/obj/structure/window/reinforced{
	dir = 1
	},
/obj/structure/shuttle/engine/heater,
/turf/open/floor/plating/airless,
/area/ruin/powered)
"Bl" = (
/obj/structure/closet/crate,
/turf/open/floor/plating,
/area/ruin/powered)
"Br" = (
/obj/structure/chair/comfy/shuttle{
	dir = 8
	},
/obj/structure/window/reinforced{
	dir = 4
	},
/turf/open/floor/mineral/plastitanium,
/area/ruin/powered)
"Bs" = (
/obj/effect/decal/cleanable/dirt,
/mob/living/simple_animal/hostile/vadimclone/prisoner/alt,
/turf/open/floor/mineral/plastitanium,
/area/ruin/powered)
"BC" = (
/obj/machinery/computer{
	dir = 4
	},
/obj/effect/decal/cleanable/dirt,
/turf/open/floor/mineral/titanium/blue,
/area/ruin/powered)
"BR" = (
/obj/effect/decal/cleanable/blood/old,
/obj/item/broken_bottle,
/turf/open/floor/mineral/plastitanium/red,
/area/ruin/powered)
"Ci" = (
/obj/structure/bed,
/obj/item/bedsheet/captain{
	desc = "A basic military blanket, for long military treks. This one belongs to a Nanotrasen Naval Captain.";
	name = "captain's thermo-cover"
	},
/turf/open/floor/mineral/plastitanium,
/area/ruin/powered)
"DX" = (
/obj/effect/decal/cleanable/dirt,
/obj/effect/decal/cleanable/blood/old,
/turf/open/floor/mineral/titanium/blue,
/area/ruin/powered)
"EL" = (
/obj/effect/decal/cleanable/dirt,
/turf/open/floor/plating,
/area/ruin/powered)
"EY" = (
/obj/structure/extinguisher_cabinet{
	pixel_x = -5;
	pixel_y = 30
	},
/obj/effect/decal/cleanable/blood/old,
/obj/machinery/light/small{
	dir = 1
	},
/obj/effect/decal/cleanable/dirt,
/obj/effect/mob_spawn/human/corpse/russian,
/turf/open/floor/mineral/titanium/blue,
/area/ruin/powered)
"Fd" = (
/obj/structure/table,
/obj/machinery/microwave{
	pixel_x = -2;
	pixel_y = 6
	},
/turf/open/floor/plating,
/area/ruin/powered)
"Fv" = (
/obj/structure/chair/comfy/shuttle{
	dir = 8
	},
/turf/open/floor/mineral/titanium,
/area/ruin/powered)
"Gc" = (
/obj/effect/spawner/structure/window/reinforced,
/turf/open/floor/plating,
/area/ruin/powered)
"Gl" = (
/obj/structure/table/reinforced,
/obj/item/reagent_containers/food/snacks/carrotfries,
/turf/open/floor/plating,
/area/ruin/powered)
"GS" = (
/turf/closed/wall/r_wall/rust,
/area/ruin/powered)
"HF" = (
/obj/effect/decal/cleanable/dirt,
/turf/open/floor/mineral/titanium,
/area/ruin/powered)
"HH" = (
/obj/item/broken_bottle,
/obj/effect/decal/cleanable/blood/old,
/turf/open/floor/mineral/plastitanium/red,
/area/ruin/powered)
"Ix" = (
/obj/structure/window/reinforced{
	dir = 4
	},
/turf/open/floor/mineral/plastitanium,
/area/ruin/powered)
"Jp" = (
/obj/structure/shuttle/engine/propulsion,
/turf/open/floor/plating,
/area/ruin/powered)
"JC" = (
/obj/effect/decal/cleanable/dirt,
/obj/machinery/light/small{
	dir = 1
	},
/turf/open/floor/mineral/plastitanium/red,
/area/ruin/powered)
"JH" = (
/obj/structure/table,
/obj/item/kitchen/knife,
/turf/open/floor/plating,
/area/ruin/powered)
"Ka" = (
/turf/open/floor/plating/airless,
/area/ruin/powered)
"Kc" = (
/obj/structure/table,
/obj/item/reagent_containers/food/drinks/bottle/vodka/badminka{
	pixel_x = 5;
	pixel_y = 12
	},
/obj/item/reagent_containers/food/drinks/beer/light{
	pixel_x = -4;
	pixel_y = 4
	},
/turf/open/floor/mineral/titanium/blue,
/area/ruin/powered)
"KM" = (
/obj/machinery/door/airlock/security/glass{
	name = "Kitchen"
	},
/turf/open/floor/mineral/plastitanium,
/area/ruin/powered)
"Li" = (
/obj/effect/decal/cleanable/dirt,
/obj/structure/kitchenspike,
/turf/open/floor/plating,
/area/ruin/powered)
"Lt" = (
/obj/structure/table,
/obj/item/storage/firstaid/regular{
	pixel_x = 2;
	pixel_y = 3
	},
/obj/item/crowbar,
/obj/effect/decal/cleanable/dirt,
/turf/open/floor/mineral/titanium/blue,
/area/ruin/powered)
"LU" = (
/obj/item/pickaxe/mini,
/turf/open/floor/mineral/plastitanium/red,
/area/ruin/powered)
"On" = (
/obj/effect/decal/cleanable/dirt,
/obj/effect/decal/cleanable/blood/old,
/turf/open/floor/mineral/plastitanium/red,
/area/ruin/powered)
"Ot" = (
/obj/effect/decal/cleanable/blood/tracks{
	dir = 8
	},
/turf/open/floor/mineral/plastitanium/red,
/area/ruin/powered)
"OG" = (
/obj/structure/table,
/turf/open/floor/mineral/titanium/blue,
/area/ruin/powered)
"Pn" = (
/obj/structure/window/reinforced{
	dir = 1
	},
/turf/open/floor/plating/airless,
/area/ruin/powered)
"PG" = (
/obj/machinery/computer/shuttle,
/turf/open/floor/mineral/titanium/blue,
/area/ruin/powered)
"Qa" = (
/obj/structure/shuttle/engine/heater,
/obj/structure/window/reinforced{
	dir = 1
	},
/turf/open/floor/plating,
/area/ruin/powered)
"Qf" = (
/obj/effect/decal/cleanable/vomit/old,
/turf/open/floor/plating,
/area/ruin/powered)
"QR" = (
/obj/structure/table,
/turf/open/floor/plating,
/area/ruin/powered)
"QX" = (
/obj/structure/chair/comfy/shuttle{
	dir = 4
	},
/turf/open/floor/mineral/plastitanium/red,
/area/ruin/powered)
"Tf" = (
/obj/structure/chair/comfy/shuttle{
	dir = 4
	},
/turf/open/floor/mineral/plastitanium,
/area/ruin/powered)
"Th" = (
/obj/structure/chair/comfy/shuttle{
	dir = 8
	},
/turf/open/floor/mineral/plastitanium/red,
/area/ruin/powered)
"Ua" = (
/obj/machinery/door/airlock/public/glass,
/turf/open/floor/mineral/titanium,
/area/ruin/powered)
"Up" = (
/turf/open/floor/mineral/plastitanium/red,
/area/ruin/powered)
"Uz" = (
/obj/structure/table,
/obj/item/crowbar/large{
	pixel_x = 6
	},
/obj/effect/decal/cleanable/dirt,
/turf/open/floor/mineral/plastitanium,
/area/ruin/powered)
"UK" = (
/turf/open/floor/mineral/plastitanium,
/area/ruin/powered)
"Vk" = (
/obj/structure/table,
/obj/item/seeds/garlic{
	pixel_x = -12
	},
/turf/open/floor/mineral/plastitanium,
/area/ruin/powered)
"VI" = (
/obj/machinery/computer/crew{
	dir = 4
	},
/obj/machinery/light{
	dir = 8
	},
/obj/effect/decal/cleanable/dirt,
/turf/open/floor/mineral/titanium/blue,
/area/ruin/powered)
"VM" = (
/obj/structure/bed{
	dir = 1
	},
/turf/open/floor/mineral/plastitanium,
/area/ruin/powered)
"Yc" = (
/obj/effect/decal/cleanable/glass,
/turf/open/floor/mineral/plastitanium,
/area/ruin/powered)
"Ys" = (
/obj/structure/shuttle/engine/large,
/turf/open/floor/plating/airless,
/area/ruin/powered)
"YN" = (
/obj/structure/shuttle/engine/propulsion,
/turf/open/floor/plating/airless,
/area/ruin/powered)
"Zy" = (
/obj/effect/decal/cleanable/dirt,
/turf/open/floor/mineral/titanium/blue,
/area/ruin/powered)
"ZO" = (
/obj/effect/decal/cleanable/blood/tracks{
	dir = 6
	},
/turf/open/floor/mineral/plastitanium/red,
/area/ruin/powered)
"ZT" = (
/mob/living/simple_animal/hostile/vadimclone/prisoner,
/turf/open/floor/mineral/titanium,
/area/ruin/powered)

(1,1,1) = {"
ze
ze
ze
ze
ze
ze
ze
ze
zG
mF
bI
Gc
Gc
Gc
bI
mF
bI
ze
ze
ze
ze
ze
"}
(2,1,1) = {"
ze
ze
ze
ze
bI
zG
bI
zG
bI
Up
Tf
Tf
UK
Tf
dy
Up
zG
bI
bI
zG
ze
ze
"}
(3,1,1) = {"
ze
ze
ze
ze
bI
nB
wP
aQ
bI
ko
Up
lC
Up
Up
Up
jB
bI
Li
JH
zG
bI
ze
"}
(4,1,1) = {"
ze
bI
zG
zG
zG
nB
kh
nB
zG
Ot
vL
UK
Yc
Ix
Ix
lo
KM
tx
nR
yv
bI
bI
"}
(5,1,1) = {"
zG
zG
VI
BC
bI
Gc
wv
Gc
bI
mt
ox
Tf
aE
aE
aE
Up
bI
oz
EL
Bl
Pn
Ys
"}
(6,1,1) = {"
Gc
jA
Fv
yP
bI
cx
gU
lU
pO
ZO
lo
Up
On
Up
lC
lo
Gl
Qf
tx
dK
Pn
Ka
"}
(7,1,1) = {"
Gc
Kc
oL
uX
Ua
Up
lo
Up
LU
Up
lo
lo
uu
lo
lo
Up
oe
tx
tx
QR
Qa
Jp
"}
(8,1,1) = {"
Gc
PG
lm
HF
Gc
Up
Br
Br
UK
UK
rB
sf
sf
sf
sf
pr
zG
dD
nr
Fd
GS
sa
"}
(9,1,1) = {"
Gc
PG
rw
HF
Gc
JC
fp
fp
bD
Yc
Vk
sf
sf
sf
sf
Up
bI
bI
bI
bI
GS
GS
"}
(10,1,1) = {"
Gc
OG
ZT
HF
Ua
Up
lo
lo
lo
BR
Up
sz
Up
Up
Up
Up
bI
DX
wu
ax
Bg
YN
"}
(11,1,1) = {"
Gc
Lt
HF
HF
zG
Up
Up
lo
lo
lo
lo
lo
QX
Up
HH
Up
Gc
mr
wZ
mr
Pn
Ys
"}
(12,1,1) = {"
bI
zG
cj
Zy
zG
UK
UK
uH
Ci
lo
bD
qG
mI
Uz
UK
Up
li
mr
mr
cO
Pn
Ka
"}
(13,1,1) = {"
ze
bI
zG
bI
bI
VM
VM
VM
rs
lo
bD
bD
eF
fB
Bs
Up
Gc
mr
mr
yy
bI
bI
"}
(14,1,1) = {"
ze
ze
ze
ze
bI
Up
Up
Up
bN
Up
Up
Up
xC
Th
Up
Up
bI
EY
oJ
bI
bI
ze
"}
(15,1,1) = {"
ze
ze
ze
ze
bI
bI
bI
zG
zG
Up
cq
UK
UK
UK
oW
Up
zG
be
zG
bI
ze
ze
"}
(16,1,1) = {"
ze
ze
ze
ze
ze
ze
ze
ze
zG
ve
GS
Gc
Gc
Gc
bI
ve
zG
ze
ze
ze
ze
ze
"}
