//MAP CONVERTED BY dmm2tgm.py THIS HEADER COMMENT PREVENTS RECONVERSION, DO NOT REMOVE
"a" = (
/turf/template_noop,
/area/template_noop)
"b" = (
/turf/closed/mineral/random,
/area/ruin/space/has_grav)
"c" = (
/turf/open/floor/plating/asteroid/airless,
/area/ruin/space/has_grav)
"d" = (
/obj/structure/marker_beacon{
	light_color = "#FFE8AA";
	light_range = 20
	},
/turf/open/floor/plating/asteroid,
/area/ruin/space/has_grav)
"e" = (
/obj/structure/flora/ausbushes/fullgrass,
/turf/open/floor/plating/asteroid,
/area/ruin/space/has_grav)
"f" = (
/obj/structure/flora/ausbushes/ywflowers,
/turf/open/floor/plating/asteroid,
/area/ruin/space/has_grav)
"h" = (
/mob/living/simple_animal/pet/gondola,
/turf/open/floor/plating/asteroid,
/area/ruin/space/has_grav)
"i" = (
/obj/structure/flora/ausbushes/sparsegrass,
/turf/open/floor/plating/asteroid,
/area/ruin/space/has_grav)
"j" = (
/obj/effect/overlay/coconut,
/turf/open/floor/plating/asteroid,
/area/ruin/space/has_grav)
"k" = (
/obj/effect/overlay/palmtree_l,
/turf/open/floor/plating/asteroid,
/area/ruin/space/has_grav)
"l" = (
/obj/structure/flora/ausbushes/stalkybush,
/turf/open/floor/plating/asteroid,
/area/ruin/space/has_grav)
"m" = (
/obj/structure/flora/ausbushes/grassybush,
/turf/open/floor/plating/asteroid,
/area/ruin/space/has_grav)
"n" = (
/obj/structure/flora/ausbushes/reedbush,
/turf/open/floor/plating/asteroid,
/area/ruin/space/has_grav)
"o" = (
/obj/structure/flora/ausbushes/lavendergrass,
/turf/open/floor/plating/asteroid,
/area/ruin/space/has_grav)
"p" = (
/obj/structure/flora/ausbushes/brflowers,
/turf/open/floor/plating/asteroid,
/area/ruin/space/has_grav)
"q" = (
/obj/structure/flora/ausbushes/fernybush,
/turf/open/floor/plating/asteroid,
/area/ruin/space/has_grav)
"r" = (
/obj/effect/overlay/palmtree_r,
/turf/open/floor/plating/asteroid,
/area/ruin/space/has_grav)
"s" = (
/obj/structure/flora/junglebush/large,
/turf/open/floor/plating/asteroid,
/area/ruin/space/has_grav)
"t" = (
/obj/structure/flora/ausbushes/sunnybush,
/turf/open/floor/plating/asteroid,
/area/ruin/space/has_grav)
"u" = (
/obj/machinery/door/airlock/survival_pod/glass{
	dir = 4
	},
/obj/effect/mapping_helpers/airlock/cyclelink_helper,
/turf/open/floor/plating,
/area/ruin/space/has_grav)
"v" = (
/obj/item/storage/bag/easterbasket{
	name = "picnic basket";
	pixel_x = 9;
	pixel_y = 18
	},
/turf/open/floor/carpet/blue,
/area/ruin/space/has_grav)
"A" = (
/turf/open/water/asteroid,
/area/ruin/space/has_grav)
"F" = (
/turf/open/floor/carpet/blue,
/area/ruin/space/has_grav)
"H" = (
/turf/open/floor/plating,
/area/ruin/space/has_grav)
"O" = (
/turf/open/floor/plating/asteroid,
/area/ruin/space/has_grav)
"T" = (
/obj/machinery/door/airlock/survival_pod/glass{
	dir = 4
	},
/obj/effect/mapping_helpers/airlock/cyclelink_helper{
	dir = 1
	},
/turf/open/floor/plating,
/area/ruin/space/has_grav)

(1,1,1) = {"
a
a
a
a
a
a
a
a
a
a
a
a
a
a
a
a
a
a
a
a
a
a
a
a
a
a
b
b
b
b
b
b
a
a
a
"}
(2,1,1) = {"
a
a
a
a
b
b
a
a
a
a
a
a
a
a
a
a
a
a
a
a
a
a
a
a
b
b
b
b
b
b
b
b
b
a
a
"}
(3,1,1) = {"
a
a
b
b
b
b
b
a
a
a
a
a
a
a
a
a
a
a
a
b
b
b
b
b
b
b
b
b
b
b
b
b
b
b
c
"}
(4,1,1) = {"
a
b
b
b
b
a
a
a
a
a
a
a
a
a
a
b
b
b
b
b
b
b
b
b
b
b
b
b
b
O
b
b
b
b
b
"}
(5,1,1) = {"
a
b
b
b
a
a
a
a
a
a
a
a
a
a
b
b
b
b
b
b
b
b
b
b
b
O
O
O
O
O
O
O
b
b
b
"}
(6,1,1) = {"
a
a
a
a
a
a
a
a
a
b
b
b
b
b
b
b
b
b
b
b
b
b
b
O
O
O
O
f
O
O
O
h
O
b
b
"}
(7,1,1) = {"
a
a
a
a
a
a
a
a
b
b
b
b
b
b
b
b
b
b
b
b
b
O
O
O
O
o
O
r
O
b
b
b
b
b
c
"}
(8,1,1) = {"
a
a
a
a
a
a
b
b
b
b
b
b
b
b
b
b
O
b
O
O
O
O
O
O
O
O
j
O
O
O
O
b
b
b
c
"}
(9,1,1) = {"
a
a
a
a
a
b
b
b
b
b
b
b
b
O
k
O
O
q
O
O
j
O
O
k
O
O
O
O
m
O
O
b
b
b
c
"}
(10,1,1) = {"
a
a
a
b
b
b
b
b
b
b
b
b
b
b
b
O
O
O
O
O
s
O
O
O
O
O
O
i
O
O
O
b
b
b
c
"}
(11,1,1) = {"
a
a
b
b
b
b
b
b
b
b
b
b
b
b
O
i
n
f
O
O
d
O
O
j
O
h
O
l
O
d
O
b
b
b
c
"}
(12,1,1) = {"
a
a
b
b
b
b
b
b
b
b
b
b
O
O
O
O
o
o
O
h
O
O
O
O
O
O
O
i
o
O
O
b
b
b
c
"}
(13,1,1) = {"
a
b
b
b
b
b
b
b
b
b
b
b
O
O
O
O
i
O
q
O
O
O
O
O
O
s
O
O
O
O
b
b
b
b
c
"}
(14,1,1) = {"
a
b
b
b
b
b
b
b
b
b
b
h
O
O
O
O
l
O
O
O
m
i
O
O
O
O
O
O
O
b
b
b
b
b
c
"}
(15,1,1) = {"
a
b
b
b
b
b
b
b
b
b
b
b
b
b
b
O
O
O
O
O
i
o
O
O
O
O
O
O
O
O
b
b
b
b
c
"}
(16,1,1) = {"
a
b
b
b
b
b
b
b
b
b
b
b
b
b
b
b
b
O
O
O
o
p
O
O
O
O
r
O
O
O
O
b
b
b
c
"}
(17,1,1) = {"
a
b
b
b
b
b
b
b
b
b
b
b
b
b
b
b
b
b
O
e
n
O
O
O
O
O
O
O
O
O
O
O
b
b
c
"}
(18,1,1) = {"
a
b
b
b
b
b
b
b
b
b
O
e
O
b
b
b
b
b
O
O
O
O
O
O
i
t
O
O
O
i
O
O
b
b
b
"}
(19,1,1) = {"
a
b
b
b
b
b
b
b
b
O
O
O
O
O
O
b
b
b
b
O
r
j
O
O
O
f
O
O
O
O
O
O
u
H
T
"}
(20,1,1) = {"
a
c
b
b
b
b
b
b
b
h
O
O
d
O
O
O
O
O
O
O
O
O
O
O
O
O
O
O
O
O
O
b
b
b
b
"}
(21,1,1) = {"
a
c
c
b
b
b
b
b
b
O
O
O
k
O
i
i
O
O
q
O
O
O
O
O
d
O
h
O
O
O
O
O
b
b
b
"}
(22,1,1) = {"
a
c
c
b
b
b
b
b
b
O
O
O
O
O
O
l
O
O
F
v
O
O
O
O
O
O
O
O
O
r
O
O
b
b
b
"}
(23,1,1) = {"
a
c
c
b
b
b
b
b
b
O
O
j
A
A
O
O
O
O
F
F
O
h
s
O
O
O
s
O
O
O
O
O
b
b
b
"}
(24,1,1) = {"
a
a
c
c
b
b
b
b
e
O
O
A
A
A
h
O
O
O
O
O
O
O
O
O
m
O
O
O
O
O
O
O
b
b
b
"}
(25,1,1) = {"
a
a
c
c
b
b
b
O
O
O
A
A
A
A
A
O
i
l
O
O
O
O
O
O
n
m
O
O
O
O
O
b
b
b
a
"}
(26,1,1) = {"
a
a
c
c
b
b
b
O
O
O
A
A
A
A
A
m
p
i
O
f
O
O
O
O
O
O
k
O
O
j
O
b
b
b
a
"}
(27,1,1) = {"
a
a
c
c
b
b
b
b
O
O
A
A
A
A
O
O
O
O
O
d
m
i
O
O
O
O
O
O
O
O
b
b
b
a
a
"}
(28,1,1) = {"
a
a
a
c
c
b
b
b
O
O
O
A
O
e
O
O
O
O
O
O
i
l
p
O
O
O
O
O
O
b
b
b
b
a
a
"}
(29,1,1) = {"
a
a
a
c
c
b
b
O
O
O
e
O
O
O
O
O
O
O
O
O
O
O
O
O
O
i
O
O
O
b
b
b
c
c
a
"}
(30,1,1) = {"
a
a
a
c
b
b
O
d
f
O
i
O
O
O
b
O
O
O
O
O
j
O
O
O
O
O
O
O
b
b
b
c
c
c
a
"}
(31,1,1) = {"
a
a
a
b
b
b
b
O
O
O
O
O
O
b
b
b
O
O
O
r
O
O
O
O
O
O
b
b
b
b
c
c
c
b
b
"}
(32,1,1) = {"
a
a
a
b
b
b
O
O
O
O
O
O
b
b
b
b
b
b
b
b
b
b
b
b
b
b
b
b
b
b
c
c
b
b
b
"}
(33,1,1) = {"
a
a
a
b
b
O
O
O
O
b
b
b
b
b
b
b
b
b
b
b
b
b
b
b
b
b
b
b
b
a
a
b
b
b
a
"}
(34,1,1) = {"
a
a
a
b
b
b
b
b
b
b
b
b
b
b
c
c
c
c
c
b
b
b
b
b
a
a
a
a
a
a
a
b
b
b
a
"}
(35,1,1) = {"
a
a
a
a
b
b
b
b
b
b
b
b
b
a
a
a
a
a
a
a
a
a
a
a
a
a
a
a
a
a
a
a
a
a
a
"}
