//MAP CONVERTED BY dmm2tgm.py THIS HEADER COMMENT PREVENTS RECONVERSION, DO NOT REMOVE
"aU" = (
/obj/structure/chair/comfy/shuttle{
	dir = 8
	},
/obj/effect/mob_spawn/human/golem/adamantine,
/turf/open/floor/mineral/titanium/blue,
/area/ruin/powered/golem_ship)
"cv" = (
/obj/structure/closet/crate,
/obj/item/shovel,
/obj/item/shovel,
/obj/item/pickaxe,
/obj/item/pickaxe,
/obj/item/storage/bag/ore,
/obj/item/storage/bag/ore,
/obj/item/mining_scanner,
/obj/item/flashlight/lantern,
/obj/item/card/id/mining,
/obj/item/gps/mining{
	tracking = 0
	},
/obj/effect/turf_decal/bot,
/turf/open/floor/plating,
/area/ruin/powered/golem_ship)
"db" = (
/obj/effect/turf_decal/bot,
/obj/machinery/light/small,
/turf/open/floor/plating,
/area/ruin/powered/golem_ship)
"dc" = (
/obj/machinery/light,
/turf/open/floor/mineral/titanium/white,
/area/ruin/powered/golem_ship)
"dB" = (
/obj/machinery/mineral/equipment_vendor/golem,
/turf/open/floor/mineral/titanium/yellow,
/area/ruin/powered/golem_ship)
"eS" = (
/turf/open/floor/plating{
	initial_gas_mix = "o2=14;n2=23;TEMP=300"
	},
/area/ruin/powered/golem_ship)
"hY" = (
/obj/structure/chair/comfy/shuttle{
	dir = 8
	},
/obj/effect/mob_spawn/human/golem/adamantine,
/turf/open/floor/mineral/titanium/white,
/area/ruin/powered/golem_ship)
"iq" = (
/obj/machinery/light/small{
	dir = 1
	},
/obj/structure/ore_box,
/obj/effect/turf_decal/bot,
/turf/open/floor/plating,
/area/ruin/powered/golem_ship)
"iz" = (
/obj/effect/turf_decal/bot,
/turf/open/floor/plating,
/area/ruin/powered/golem_ship)
"jd" = (
/obj/machinery/door/airlock/titanium,
/obj/effect/mapping_helpers/airlock/cyclelink_helper{
	dir = 4
	},
/turf/open/floor/plating,
/area/ruin/powered/golem_ship)
"jI" = (
/obj/structure/closet/crate,
/obj/item/shovel,
/obj/item/shovel,
/obj/item/shovel,
/obj/item/pickaxe,
/obj/item/pickaxe,
/obj/item/pickaxe,
/obj/item/storage/bag/ore,
/obj/item/storage/bag/ore,
/obj/item/mining_scanner,
/obj/item/flashlight/lantern,
/obj/item/card/id/mining,
/obj/item/gps/mining{
	tracking = 0
	},
/obj/effect/turf_decal/bot,
/turf/open/floor/plating,
/area/ruin/powered/golem_ship)
"jS" = (
/obj/structure/extinguisher_cabinet{
	pixel_y = -30
	},
/turf/open/floor/plating,
/area/ruin/powered/golem_ship)
"lj" = (
/obj/structure/extinguisher_cabinet{
	pixel_x = -27
	},
/turf/open/floor/mineral/titanium/white,
/area/ruin/powered/golem_ship)
"nj" = (
/obj/machinery/light{
	dir = 1
	},
/obj/machinery/autolathe,
/turf/open/floor/mineral/titanium/purple,
/area/ruin/powered/golem_ship)
"np" = (
/obj/machinery/door/airlock/titanium,
/turf/open/floor/mineral/titanium/purple,
/area/ruin/powered/golem_ship)
"og" = (
/turf/open/floor/plating,
/area/ruin/powered/golem_ship)
"op" = (
/obj/structure/frame/computer,
/turf/open/floor/mineral/plastitanium,
/area/ruin/powered/golem_ship)
"pt" = (
/obj/structure/shuttle/engine/large{
	dir = 4
	},
/turf/open/floor/plating{
	initial_gas_mix = "o2=14;n2=23;TEMP=300"
	},
/area/ruin/powered/golem_ship)
"qM" = (
/obj/structure/closet/crate,
/obj/item/shovel,
/obj/item/shovel,
/obj/item/pickaxe,
/obj/item/pickaxe,
/obj/item/storage/bag/ore,
/obj/item/storage/bag/ore,
/obj/item/mining_scanner,
/obj/item/flashlight/lantern,
/obj/item/card/id/mining,
/obj/item/gps/mining{
	tracking = 0
	},
/turf/open/floor/plating,
/area/ruin/powered/golem_ship)
"qU" = (
/obj/structure/rack,
/obj/item/bedsheet/rd/royal_cape{
	layer = 3;
	pixel_x = 5;
	pixel_y = 9
	},
/obj/structure/window/reinforced{
	name = "shrine of the liberator"
	},
/obj/machinery/light/small{
	dir = 1
	},
/turf/open/floor/mineral/titanium/yellow,
/area/ruin/powered/golem_ship)
"rE" = (
/obj/machinery/computer/arcade/orion_trail{
	dir = 4;
	icon_state = "arcade"
	},
/turf/open/floor/mineral/titanium/yellow,
/area/ruin/powered/golem_ship)
"sw" = (
/obj/structure/rack,
/obj/item/book/manual/wiki/research_and_development{
	name = "Sacred Text of the Liberator";
	pixel_x = -4;
	pixel_y = 3
	},
/obj/structure/window/reinforced{
	dir = 4;
	name = "shrine of the liberator"
	},
/obj/structure/window/reinforced{
	name = "shrine of the liberator"
	},
/turf/open/floor/mineral/titanium/yellow,
/area/ruin/powered/golem_ship)
"sF" = (
/obj/machinery/computer/shuttle{
	dir = 4
	},
/turf/open/floor/mineral/titanium/blue,
/area/ruin/powered/golem_ship)
"tZ" = (
/obj/structure/reagent_dispensers/fueltank,
/obj/effect/turf_decal/delivery,
/turf/open/floor/plating,
/area/ruin/powered/golem_ship)
"uF" = (
/obj/structure/shuttle/engine/heater{
	dir = 4
	},
/obj/structure/window/reinforced{
	dir = 8
	},
/turf/open/floor/plating{
	initial_gas_mix = "o2=14;n2=23;TEMP=300"
	},
/area/ruin/powered/golem_ship)
"vz" = (
/obj/machinery/light/small{
	dir = 1
	},
/turf/open/floor/mineral/titanium/white,
/area/ruin/powered/golem_ship)
"vC" = (
/obj/machinery/mineral/ore_redemption,
/obj/machinery/light{
	dir = 4
	},
/turf/open/floor/mineral/titanium/purple,
/area/ruin/powered/golem_ship)
"vY" = (
/turf/closed/wall/mineral/titanium/nodiagonal,
/area/ruin/powered/golem_ship)
"yc" = (
/obj/machinery/door/airlock/titanium/glass,
/turf/open/floor/mineral/titanium/white,
/area/ruin/powered/golem_ship)
"zb" = (
/turf/open/floor/mineral/titanium/purple,
/area/ruin/powered/golem_ship)
"zc" = (
/turf/open/floor/mineral/plastitanium,
/area/ruin/powered/golem_ship)
"Al" = (
/obj/machinery/light/small,
/turf/open/floor/mineral/titanium/white,
/area/ruin/powered/golem_ship)
"CV" = (
/obj/effect/spawner/structure/window/shuttle,
/turf/open/floor/plating,
/area/ruin/powered/golem_ship)
"Db" = (
/obj/structure/shuttle/engine/propulsion{
	dir = 4
	},
/turf/open/floor/plating{
	initial_gas_mix = "o2=14;n2=23;TEMP=300"
	},
/area/ruin/powered/golem_ship)
"Dz" = (
/turf/template_noop,
/area/template_noop)
"Eb" = (
/obj/machinery/light{
	dir = 8
	},
/turf/open/floor/mineral/titanium/purple,
/area/ruin/powered/golem_ship)
"EA" = (
/turf/open/floor/mineral/titanium/yellow,
/area/ruin/powered/golem_ship)
"EH" = (
/obj/effect/turf_decal/loading_area,
/turf/open/floor/mineral/titanium/purple,
/area/ruin/powered/golem_ship)
"Fe" = (
/obj/structure/frame,
/turf/open/floor/mineral/plastitanium,
/area/ruin/powered/golem_ship)
"FR" = (
/obj/machinery/light{
	dir = 4
	},
/turf/open/floor/mineral/titanium/purple,
/area/ruin/powered/golem_ship)
"HJ" = (
/obj/machinery/door/airlock/titanium,
/obj/effect/mapping_helpers/airlock/cyclelink_helper{
	dir = 8
	},
/turf/open/floor/plating,
/area/ruin/powered/golem_ship)
"IH" = (
/obj/structure/table/reinforced,
/obj/item/areaeditor/blueprints{
	desc = "Use to build new structures in the wastes.";
	name = "land claim"
	},
/turf/open/floor/mineral/titanium/yellow,
/area/ruin/powered/golem_ship)
"JP" = (
/obj/structure/window/reinforced{
	name = "shrine of the liberator"
	},
/obj/structure/statue/gold/rd{
	pixel_y = 3
	},
/turf/open/floor/mineral/titanium/yellow,
/area/ruin/powered/golem_ship)
"KE" = (
/obj/machinery/door/airlock/titanium,
/obj/structure/fans/tiny,
/turf/open/floor/plating,
/area/ruin/powered/golem_ship)
"Lu" = (
/obj/structure/reagent_dispensers/watertank,
/obj/effect/turf_decal/delivery,
/turf/open/floor/plating,
/area/ruin/powered/golem_ship)
"MR" = (
/obj/machinery/light{
	dir = 8
	},
/obj/machinery/computer/shuttle{
	dir = 4
	},
/turf/open/floor/mineral/titanium/blue,
/area/ruin/powered/golem_ship)
"Ny" = (
/obj/structure/table/reinforced,
/obj/machinery/light/small,
/obj/item/resonator/upgraded{
	pixel_x = 15;
	pixel_y = 1
	},
/obj/item/disk/design_disk/golem_shell,
/turf/open/floor/mineral/titanium/yellow,
/area/ruin/powered/golem_ship)
"Od" = (
/obj/machinery/light{
	dir = 1
	},
/turf/open/floor/mineral/titanium/yellow,
/area/ruin/powered/golem_ship)
"Ph" = (
/obj/structure/table/reinforced,
/obj/item/surgical_drapes{
	pixel_x = -3;
	pixel_y = 3
	},
/obj/item/storage/firstaid/fire{
	pixel_x = 6;
	pixel_y = 8
	},
/obj/item/storage/firstaid/fire{
	pixel_x = 6
	},
/turf/open/floor/mineral/titanium/white,
/area/ruin/powered/golem_ship)
"Pu" = (
/obj/structure/table/reinforced,
/obj/item/storage/firstaid/brute{
	pixel_x = 6;
	pixel_y = 8
	},
/obj/item/storage/firstaid/brute{
	pixel_x = 6
	},
/turf/open/floor/mineral/titanium/white,
/area/ruin/powered/golem_ship)
"QG" = (
/turf/open/floor/mineral/titanium/blue,
/area/ruin/powered/golem_ship)
"Rf" = (
/obj/effect/turf_decal/bot,
/obj/machinery/light/small{
	dir = 1
	},
/turf/open/floor/plating,
/area/ruin/powered/golem_ship)
"Rx" = (
/turf/open/floor/mineral/titanium/white,
/area/ruin/powered/golem_ship)
"RN" = (
/obj/structure/chair/comfy/shuttle{
	dir = 8
	},
/turf/open/floor/mineral/titanium/white,
/area/ruin/powered/golem_ship)
"Vf" = (
/obj/structure/ore_box,
/obj/effect/turf_decal/bot,
/turf/open/floor/plating,
/area/ruin/powered/golem_ship)
"Wg" = (
/obj/structure/extinguisher_cabinet{
	pixel_y = -30
	},
/obj/machinery/light,
/obj/structure/table/reinforced,
/obj/item/gps/mining{
	tracking = 0
	},
/turf/open/floor/mineral/titanium/purple,
/area/ruin/powered/golem_ship)
"WJ" = (
/obj/machinery/light/small,
/turf/open/floor/plating,
/area/ruin/powered/golem_ship)
"Xn" = (
/obj/structure/table/reinforced,
/obj/item/storage/toolbox/mechanical{
	pixel_y = 8
	},
/obj/item/storage/toolbox/mechanical,
/turf/open/floor/mineral/titanium/purple,
/area/ruin/powered/golem_ship)
"YA" = (
/obj/structure/table/reinforced,
/obj/machinery/reagentgrinder,
/turf/open/floor/mineral/titanium/purple,
/area/ruin/powered/golem_ship)
"Zp" = (
/obj/item/resonator,
/turf/open/floor/mineral/titanium/white,
/area/ruin/powered/golem_ship)
"ZP" = (
/obj/structure/extinguisher_cabinet{
	pixel_y = 30
	},
/turf/open/floor/plating,
/area/ruin/powered/golem_ship)

(1,1,1) = {"
Dz
Dz
Dz
Dz
Dz
Dz
vY
CV
CV
CV
vY
Dz
Dz
Dz
Dz
Dz
Dz
"}
(2,1,1) = {"
Dz
Dz
Dz
Dz
Dz
vY
vY
MR
sF
sF
vY
vY
Dz
Dz
Dz
Dz
Dz
"}
(3,1,1) = {"
Dz
Dz
Dz
Dz
Dz
vY
qU
QG
aU
QG
Ny
vY
Dz
Dz
Dz
Dz
Dz
"}
(4,1,1) = {"
Dz
Dz
Dz
Dz
Dz
vY
JP
QG
QG
QG
IH
vY
Dz
Dz
Dz
Dz
Dz
"}
(5,1,1) = {"
Dz
Dz
Dz
vY
vY
vY
sw
QG
QG
QG
rE
vY
vY
vY
Dz
Dz
Dz
"}
(6,1,1) = {"
Dz
Dz
Dz
vY
vz
Rx
Rx
Rx
Rx
Rx
Rx
lj
Al
vY
Dz
Dz
Dz
"}
(7,1,1) = {"
Dz
Dz
Dz
KE
Zp
Zp
Rx
Rx
Rx
Rx
Rx
Zp
Zp
KE
Dz
Dz
Dz
"}
(8,1,1) = {"
vY
vY
vY
vY
hY
hY
RN
Rx
Rx
Rx
RN
hY
hY
vY
vY
vY
vY
"}
(9,1,1) = {"
vY
jI
cv
vY
vY
CV
CV
vY
yc
vY
CV
CV
vY
vY
Vf
Vf
vY
"}
(10,1,1) = {"
vY
jI
qM
vY
Xn
zb
zb
Eb
zb
Eb
zb
zb
YA
vY
iq
Vf
vY
"}
(11,1,1) = {"
vY
iz
db
vY
nj
zb
zb
Fe
zc
Fe
zb
zb
Wg
vY
Rf
Vf
vY
"}
(12,1,1) = {"
KE
og
og
np
zb
zb
zb
op
zc
Fe
zb
zb
zb
np
og
og
KE
"}
(13,1,1) = {"
vY
og
jS
vY
zb
zb
zb
zc
zc
zc
zb
zb
zb
vY
og
og
vY
"}
(14,1,1) = {"
vY
Lu
Lu
vY
EA
EA
zb
zb
zb
zb
zb
Rx
Rx
vY
tZ
tZ
vY
"}
(15,1,1) = {"
vY
uF
uF
vY
Od
EA
vC
EH
zb
zb
FR
Rx
dc
vY
uF
uF
vY
"}
(16,1,1) = {"
vY
eS
pt
vY
EA
dB
vY
jd
CV
jd
vY
Pu
Ph
vY
eS
pt
vY
"}
(17,1,1) = {"
Dz
Dz
Dz
vY
uF
uF
vY
ZP
og
WJ
vY
uF
uF
vY
Dz
Dz
Dz
"}
(18,1,1) = {"
Dz
Dz
Dz
vY
Db
Db
vY
HJ
CV
HJ
vY
Db
Db
vY
Dz
Dz
Dz
"}
