//MAP CONVERTED BY dmm2tgm.py THIS HEADER COMMENT PREVENTS RECONVERSION, DO NOT REMOVE
"a" = (
/turf/template_noop,
/area/template_noop)
"b" = (
/obj/structure/table,
/obj/item/storage/toolbox/emergency{
	pixel_x = -3;
	pixel_y = 3
	},
/obj/item/storage/toolbox/emergency,
/turf/open/floor/mineral/titanium,
/area/shuttle/arrival)
"c" = (
/obj/machinery/light/small,
/turf/open/floor/mineral/titanium/white,
/area/shuttle/arrival)
"h" = (
/obj/machinery/door/airlock/titanium{
	name = "Arrivals Shuttle Airlock"
	},
/obj/structure/fans/tiny,
/turf/open/floor/mineral/titanium/blue,
/area/shuttle/arrival)
"p" = (
/obj/machinery/requests_console{
	department = "Arrival shuttle";
	name = "Arrivals Shuttle console";
	pixel_y = 30
	},
/obj/machinery/light{
	dir = 1
	},
/obj/structure/closet/emcloset/anchored,
/turf/open/floor/mineral/titanium,
/area/shuttle/arrival)
"u" = (
/obj/item/radio/intercom{
	name = "Station Intercom (General)";
	pixel_y = -29
	},
/obj/machinery/light,
/obj/structure/closet/emcloset/anchored,
/turf/open/floor/mineral/titanium,
/area/shuttle/arrival)
"v" = (
/obj/machinery/light{
	dir = 1
	},
/turf/open/floor/mineral/titanium/white,
/area/shuttle/arrival)
"A" = (
/obj/machinery/light/small{
	dir = 1
	},
/turf/open/floor/mineral/titanium/white,
/area/shuttle/arrival)
"B" = (
/obj/effect/spawner/structure/window/shuttle,
/turf/open/floor/plating,
/area/shuttle/arrival)
"J" = (
/obj/structure/table,
/turf/open/floor/mineral/titanium,
/area/shuttle/arrival)
"L" = (
/turf/closed/wall/mineral/titanium,
/area/shuttle/arrival)
"N" = (
/obj/structure/table,
/obj/item/storage/firstaid/regular,
/turf/open/floor/mineral/titanium,
/area/shuttle/arrival)
"O" = (
/obj/structure/chair/comfy/shuttle{
	dir = 4
	},
/turf/open/floor/mineral/titanium/blue,
/area/shuttle/arrival)
"P" = (
/obj/machinery/light,
/turf/open/floor/mineral/titanium/white,
/area/shuttle/arrival)
"R" = (
/obj/structure/shuttle/engine/heater{
	dir = 4
	},
/obj/structure/window/reinforced{
	dir = 8
	},
/turf/open/floor/plating/airless,
/area/shuttle/arrival)
"W" = (
/obj/structure/shuttle/engine/propulsion/burst/right{
	dir = 4
	},
/obj/docking_port/mobile/arrivals{
	name = "Fridge Arrivals Shuttle"
	},
/turf/open/floor/plating/airless,
/area/shuttle/arrival)
"X" = (
/turf/open/floor/mineral/titanium/white,
/area/shuttle/arrival)
"Y" = (
/obj/structure/chair/comfy/shuttle{
	dir = 8
	},
/turf/open/floor/mineral/titanium/blue,
/area/shuttle/arrival)
"Z" = (
/obj/structure/shuttle/engine/propulsion/burst/right{
	dir = 4
	},
/turf/open/floor/plating/airless,
/area/shuttle/arrival)

(1,1,1) = {"
a
L
B
B
B
L
a
"}
(2,1,1) = {"
L
L
O
O
O
L
L
"}
(3,1,1) = {"
L
A
X
X
X
c
L
"}
(4,1,1) = {"
L
Y
Y
X
Y
Y
L
"}
(5,1,1) = {"
L
O
O
X
O
O
L
"}
(6,1,1) = {"
L
v
X
X
X
P
L
"}
(7,1,1) = {"
B
Y
Y
X
Y
Y
B
"}
(8,1,1) = {"
h
X
X
X
X
X
h
"}
(9,1,1) = {"
h
X
X
X
X
X
h
"}
(10,1,1) = {"
L
p
b
N
J
u
L
"}
(11,1,1) = {"
L
R
R
R
R
R
L
"}
(12,1,1) = {"
L
Z
Z
W
Z
Z
L
"}
