"a" = (/turf/template_noop,/area/space)
"b" = (/obj/structure/table,/obj/item/storage/toolbox/emergency{pixel_x = -3; pixel_y = 3},/obj/item/storage/toolbox/emergency,/turf/open/floor/mineral/titanium,/area/space)
"c" = (/obj/machinery/light/small,/turf/open/floor/mineral/titanium/white,/area/space)
"h" = (/obj/machinery/door/airlock/titanium{name = "Arrivals Shuttle Airlock"},/obj/structure/fans/tiny,/turf/open/floor/mineral/titanium/blue,/area/space)
"p" = (/obj/machinery/requests_console{department = "Arrival shuttle"; name = "Arrivals Shuttle console"; pixel_y = 30},/obj/machinery/light{dir = 1},/obj/structure/closet/emcloset/anchored,/turf/open/floor/mineral/titanium,/area/space)
"u" = (/obj/item/radio/intercom{name = "Station Intercom (General)"; pixel_y = -29},/obj/machinery/light,/obj/structure/closet/emcloset/anchored,/turf/open/floor/mineral/titanium,/area/space)
"v" = (/obj/machinery/light{dir = 1},/turf/open/floor/mineral/titanium/white,/area/space)
"A" = (/obj/machinery/light/small{dir = 1},/turf/open/floor/mineral/titanium/white,/area/space)
"B" = (/obj/effect/spawner/structure/window/shuttle,/turf/open/floor/plating,/area/space)
"J" = (/obj/structure/table,/turf/open/floor/mineral/titanium,/area/space)
"L" = (/turf/closed/wall/mineral/titanium,/area/space)
"N" = (/obj/structure/table,/obj/item/storage/firstaid/regular,/turf/open/floor/mineral/titanium,/area/space)
"O" = (/obj/structure/chair/comfy/shuttle{dir = 4},/turf/open/floor/mineral/titanium/blue,/area/space)
"P" = (/obj/machinery/light,/turf/open/floor/mineral/titanium/white,/area/space)
"R" = (/obj/structure/shuttle/engine/heater{dir = 4},/obj/structure/window/reinforced{dir = 8},/turf/open/floor/plating/airless,/area/space)
"W" = (/obj/docking_port/mobile/arrivals{name = "Snaxi Arrivals Shuttle"},/obj/structure/shuttle/engine/propulsion/burst/right{dir = 4},/turf/open/floor/plating/airless,/area/space)
"X" = (/turf/open/floor/mineral/titanium/white,/area/space)
"Y" = (/obj/structure/chair/comfy/shuttle{dir = 8},/turf/open/floor/mineral/titanium/blue,/area/space)
"Z" = (/obj/structure/shuttle/engine/propulsion/burst/right{dir = 4},/turf/open/floor/plating/airless,/area/space)

(1,1,1) = {"
aLLLLLBhhLLL
LLAYOvYXXpRZ
BOXYOXYXXbRZ
BOXXXXXXXNRW
BOXYOXYXXJRZ
LLcYOPYXXuRZ
aLLLLLBhhLLL
"}
