"bs" = (/obj/structure/table/reinforced,/obj/item/storage/firstaid/fire,/obj/item/storage/firstaid/regular{pixel_x = 2; pixel_y = 3},/obj/item/crowbar,/turf/open/floor/mineral/titanium/blue,/area/shuttle/escape)
"bM" = (/obj/machinery/status_display/evac,/turf/closed/wall/mineral/titanium,/area/shuttle/escape)
"cD" = (/obj/structure/chair/comfy/shuttle,/obj/machinery/flasher{id = "shuttle_flasher"; pixel_x = -24; pixel_y = 6},/obj/machinery/button/flasher{id = "shuttle_flasher"; pixel_x = -24; pixel_y = -6},/turf/open/floor/mineral/plastitanium/red/brig,/area/shuttle/escape)
"dn" = (/obj/machinery/door/airlock/public/glass{name = "Emergency Shuttle Infirmary"},/turf/open/floor/mineral/titanium/white,/area/shuttle/escape)
"dw" = (/turf/open/floor/mineral/plastitanium/red/brig,/area/shuttle/escape)
"dM" = (/obj/structure/chair/comfy/shuttle{dir = 4},/obj/structure/window/reinforced{dir = 8},/turf/open/floor/mineral/titanium/blue,/area/shuttle/escape)
"dS" = (/obj/machinery/button/flasher{id = "cockpit_flasher"; pixel_x = -6; pixel_y = -24},/turf/open/floor/mineral/titanium/blue,/area/shuttle/escape)
"ec" = (/obj/structure/closet/emcloset/anchored,/obj/machinery/light/small,/obj/item/radio/intercom{dir = 4; name = "Station Intercom (General)"; pixel_x = 27},/turf/open/floor/mineral/titanium/blue,/area/shuttle/escape)
"eB" = (/obj/structure/chair/comfy/shuttle,/turf/open/floor/mineral/titanium/blue,/area/shuttle/escape)
"fJ" = (/obj/structure/table/reinforced,/obj/item/storage/backpack/duffelbag/med/surgery,/turf/open/floor/mineral/titanium/white,/area/shuttle/escape)
"hr" = (/obj/structure/fans/tiny,/obj/machinery/door/airlock/titanium{name = "Emergency Shuttle Airlock"; req_access_txt = "2"},/turf/open/floor/plating,/area/shuttle/escape)
"ig" = (/turf/closed/wall/mineral/plastitanium/interior,/area/shuttle/escape)
"jE" = (/obj/structure/extinguisher_cabinet{pixel_x = 27},/obj/structure/chair/comfy/shuttle{dir = 8},/obj/machinery/light/small{dir = 4},/turf/open/floor/mineral/titanium/blue,/area/shuttle/escape)
"kE" = (/obj/structure/closet/crate,/turf/open/floor/mineral/titanium/yellow,/area/shuttle/escape)
"lI" = (/obj/structure/extinguisher_cabinet{pixel_x = 27},/obj/machinery/light/small{dir = 4},/turf/open/floor/mineral/titanium,/area/shuttle/escape)
"my" = (/obj/structure/chair/comfy/shuttle,/obj/machinery/light{dir = 1},/turf/open/floor/mineral/plastitanium/red/brig,/area/shuttle/escape)
"nm" = (/obj/structure/chair/comfy/shuttle{dir = 1},/turf/open/floor/mineral/plastitanium/red/brig,/area/shuttle/escape)
"nP" = (/obj/structure/chair/comfy/shuttle,/turf/open/floor/mineral/plastitanium/red/brig,/area/shuttle/escape)
"os" = (/obj/structure/chair/comfy/shuttle{dir = 8},/obj/structure/window/reinforced{dir = 4},/turf/open/floor/mineral/titanium/blue,/area/shuttle/escape)
"ox" = (/turf/open/floor/mineral/titanium/blue,/area/shuttle/escape)
"oM" = (/obj/machinery/door/airlock/titanium{name = "Emergency Shuttle Cargo"},/turf/open/floor/mineral/titanium/yellow,/area/shuttle/escape)
"pa" = (/obj/structure/fans/tiny,/obj/machinery/door/airlock/titanium{name = "Emergency Shuttle Airlock"},/obj/docking_port/mobile/emergency{dir = 8},/turf/open/floor/plating,/area/shuttle/escape)
"rd" = (/obj/machinery/computer/atmos_alert{dir = 4},/turf/open/floor/mineral/titanium/blue,/area/shuttle/escape)
"th" = (/obj/machinery/computer/security{dir = 8},/turf/open/floor/mineral/titanium/blue,/area/shuttle/escape)
"uW" = (/obj/structure/fans/tiny,/obj/machinery/door/airlock/titanium{name = "Emergency Shuttle Airlock"},/turf/open/floor/plating,/area/shuttle/escape)
"wi" = (/turf/open/floor/mineral/titanium,/area/shuttle/escape)
"xf" = (/turf/open/floor/mineral/titanium/white,/area/shuttle/escape)
"xB" = (/obj/item/radio/intercom{name = "Station Intercom (General)"; pixel_y = -29},/obj/structure/chair/comfy/shuttle{dir = 8},/turf/open/floor/mineral/titanium/blue,/area/shuttle/escape)
"yN" = (/obj/machinery/computer/communications{dir = 8},/turf/open/floor/mineral/titanium/blue,/area/shuttle/escape)
"yX" = (/obj/structure/closet/emcloset/anchored,/obj/structure/extinguisher_cabinet{pixel_x = -27; pixel_y = 1},/obj/machinery/light/small{dir = 8},/turf/open/floor/mineral/titanium/blue,/area/shuttle/escape)
"zc" = (/obj/structure/shuttle/engine/large,/turf/open/floor/plating/airless,/area/shuttle/escape)
"zS" = (/turf/open/floor/plating/airless,/area/shuttle/escape)
"AO" = (/obj/effect/spawner/structure/window/shuttle,/turf/open/floor/plating,/area/shuttle/escape)
"AT" = (/obj/machinery/computer/emergency_shuttle,/turf/open/floor/mineral/titanium/blue,/area/shuttle/escape)
"Bs" = (/obj/structure/closet,/turf/open/floor/mineral/titanium/yellow,/area/shuttle/escape)
"Bu" = (/obj/machinery/light,/turf/open/floor/mineral/titanium,/area/shuttle/escape)
"BH" = (/obj/structure/chair/comfy/shuttle{dir = 4},/obj/structure/extinguisher_cabinet{pixel_x = -27; pixel_y = 1},/obj/machinery/light/small{dir = 8},/turf/open/floor/mineral/titanium/blue,/area/shuttle/escape)
"Df" = (/obj/structure/table/reinforced,/obj/item/storage/firstaid/fire,/obj/item/storage/firstaid/regular{pixel_x = 2; pixel_y = 3},/obj/item/crowbar,/obj/machinery/light{dir = 1},/turf/open/floor/mineral/titanium/blue,/area/shuttle/escape)
"Dp" = (/obj/structure/table/optable,/turf/open/floor/mineral/titanium/white,/area/shuttle/escape)
"HP" = (/obj/machinery/status_display/evac,/turf/closed/wall/mineral/titanium/nodiagonal,/area/shuttle/escape)
"IB" = (/obj/machinery/light{dir = 1},/turf/open/floor/mineral/titanium,/area/shuttle/escape)
"KB" = (/turf/open/floor/mineral/plastitanium,/area/shuttle/escape)
"Lo" = (/obj/machinery/light{dir = 1},/turf/open/floor/mineral/titanium/yellow,/area/shuttle/escape)
"ME" = (/turf/closed/wall/mineral/titanium,/area/shuttle/escape)
"Nr" = (/obj/machinery/door/airlock/titanium{name = "Emergency Shuttle Cargo"; req_access_txt = "19"},/turf/open/floor/mineral/titanium/yellow,/area/shuttle/escape)
"Nx" = (/obj/structure/extinguisher_cabinet{pixel_y = -30},/turf/open/floor/mineral/titanium/blue,/area/shuttle/escape)
"NL" = (/obj/structure/chair/comfy/shuttle{dir = 1},/turf/open/floor/mineral/titanium/blue,/area/shuttle/escape)
"Oj" = (/turf/closed/wall/mineral/titanium/interior,/area/shuttle/escape)
"Ov" = (/obj/machinery/sleeper{dir = 8},/turf/open/floor/mineral/titanium/white,/area/shuttle/escape)
"PK" = (/obj/structure/window/reinforced{dir = 1},/turf/open/floor/plating/airless,/area/shuttle/escape)
"RB" = (/obj/machinery/door/airlock/public/glass{name = "Emergency Shuttle Brig"; req_access_txt = "2"},/turf/open/floor/mineral/plastitanium/red/brig,/area/shuttle/escape)
"RR" = (/obj/structure/chair/comfy/shuttle{dir = 4},/turf/open/floor/mineral/titanium/blue,/area/shuttle/escape)
"SS" = (/turf/template_noop,/area/template_noop)
"SU" = (/obj/machinery/door/airlock/public/glass{name = "Emergency Shuttle Cockpit"; req_access_txt = "19"},/turf/open/floor/mineral/plastitanium,/area/shuttle/escape)
"Vs" = (/turf/open/floor/mineral/titanium/yellow,/area/shuttle/escape)
"Wc" = (/obj/structure/table/reinforced,/obj/machinery/recharger,/obj/machinery/light{dir = 1},/turf/open/floor/mineral/titanium/blue,/area/shuttle/escape)
"Xb" = (/obj/structure/chair/comfy/shuttle{dir = 8},/turf/open/floor/mineral/titanium/blue,/area/shuttle/escape)
"Xm" = (/obj/machinery/flasher{id = "cockpit_flasher"; pixel_x = 24; pixel_y = 24},/turf/open/floor/mineral/plastitanium,/area/shuttle/escape)
"Yo" = (/obj/machinery/computer/crew{dir = 4},/turf/open/floor/mineral/titanium/blue,/area/shuttle/escape)
"Yt" = (/obj/structure/table/reinforced,/turf/open/floor/mineral/titanium/blue,/area/shuttle/escape)
"ZE" = (/obj/structure/table,/obj/item/storage/firstaid/fire,/obj/item/storage/firstaid/regular{pixel_x = 2; pixel_y = 3},/obj/item/crowbar,/obj/machinery/light/small,/turf/open/floor/mineral/titanium/white,/area/shuttle/escape)
"ZR" = (/obj/structure/shuttle/engine/propulsion,/turf/open/floor/plating/airless,/area/shuttle/escape)
"ZX" = (/obj/structure/window/reinforced{dir = 1},/obj/structure/shuttle/engine/heater,/turf/open/floor/plating/airless,/area/shuttle/escape)

(1,1,1) = {"
SSSSOjOjAOAOAOOjOjSSSS
SSMEOjWcoxAToxDfOjMESS
SSAOrdXboxNLoxRRthAOSS
SSAOYoxBNxoxdSRRyNAOSS
MEMEMEMEMESUMEbMMEMEME
MEkELoBsMEXmMEcDmynPME
AOkEVsVsNrKBRBdwdwdwAO
MEBsVsVsMEKBMEnmnmdwhr
MEAOoMAOHPSUHPAOAOAOME
MEbswiwiIBwiIBwiwiwipa
MEBHwiosdMwiosdMwijEME
AORRwiosdMwiosdMwiXbAO
AORRwiosdMwiosdMwiXbAO
AORRwiosdMwiosdMwiXbAO
MEyXwiwiwiBuwiwiwilIME
MEAOAOdnAObMwiNLNLwiuW
MEfJxfxfOvAOwieBeBwiAO
MEDpxfxfxfdnwiwiwiwiuW
igZExfxfOvAOYtYtYtecig
igigPKPKZXZXZXPKPKigig
SSigzczSZRZRZRzczSigSS
"}
